0101010010000000000010000000000110001000001010000010001000000010000011011011000000001001000000000011001000000100010000001000000100101100000000000000000101100010100000010000100010010000001000000000110000100101000000010110010000100000001000000101000100101000
1000010000001000110001000100110011000111110000000000001100000001101010100000101110010011010000101101110110000010000100010001000001110001011101001100110111000100110110000100111110001111110011111011010000010000100100101000101100010100101100100010110011010110
0110010001000100010011010010110110000100011100100000001100011101001011010111001110010100100100001010111010010110001100100100000101111100000000001100000011100010001100010110011011001000011100100001011010110010100110000010100110010001001001000001110111101010
0110011001001100000101010110110110010100111101000001001000001101001010010111001110010100100000001010110110010111100100100100000101111100101000011100010011010010011100001100011011001100011110100001011010110010000100001010100110010101111001000011110111101110
1100111001111110100101000100111010000110110101000101001000111111111010000110111111110100110000100100010110000011100100111100010001110000101101110110111001000101110110001000101000101100111111101011010001111000001100001010100110010101011100000010110011010110
0100111001011100000101000100110110000100110111000001101010111101111110000111111110010100110000010000111110000111100100101100010101111100101000110110011001111111100110001000101011100100011111100011001001110010011100001010100100010101111000000010010011000111
1010011101100010100101000000111011001010000100011000101100110111100011100011001110011111100100100101011000001111011100111111010101011000110001000000101101100100000010100000101100100111001100100001111001011001101110000010010100100001111111110000110011010110
0100011101011100000101100000110100000100000101011000001110110111010000000011001110010101110001100010011111010110110100100100100101011001100001110010001001110110000000100100101101100011001100101101001010010000000100000110100100011101001001010111110111010110
0000011001010100010101110110110110001110010100101000111110010111010000000010001110001001110101001000011001111011011100100100101101011000001100000100000001100110100100100101111001000101011101001011001101110011100100001010000110011001000010000010110111010110
1100010101000100010110000000110011100010001100011101001100010111000011000111000110010100100000011110001100000111010101110100011111111101100100000010110101100100000100100100111010100001011011100001011001100110100100000110010000010001101010010000110111101010
0000011001110011110111000100110110001101110100000000101100110111101010100000001110000101110000001000111110000011010100000101001101101000001101000100010011101110100110000100111011001110011101101111011001111010100100001000100100010101101000100010110011010111
0000010000110100100101001100110100001110010100001000001110100111001010000100001110010111110000011000010110000010010000000100011101101000101001010110010101100110100100000100110011100010011010101111111000011110110000001101100110111100110001000110010101000110
1011000101011110010001111011001010011000100001110000110100010100101000111100101001000001111111010001010001111010101011000001101000010010000100101101011010011001111001000010000001001000110101011010101100101011000010111001101101101010000100111011101100010111
1011100100011110000001111011001010111001000101110010000000100000101111011000100111110101001111010011000100010000101100100001000010000000000100111111011010010000111000011010000001001000110011111010100010100000011010011001101101100010111101111011101100000010
1011110000111010000011010111000010001100010001100010110010000000101000001100100001011101110101000000110100110000101010011011001001100010011100111101111000010101111010111010100110011110100011011110100101001110010000011000110100101011100101101010011000010111
1011100100111110010000111010111011111001000001110010000001100101001111011000100101110001001111011011110000010000101100001001000010100000010100001101000010010000111000001011000011001000110010111000101000001000011010101001111101100010111100111001101101000011
1110000100111010010101101011001011001000001001110000000000110000101011010001100010010001110111000001001100101010101001100101000000100110110100101011011010010100011001110001100011111000111011110010100110101100000010011001110110100010010111111001011100100111
1011010001111011010001110011111011011001001101100010010001010101101000101100101010100011110111111001111000011010101100000001001100100010010100001101110010111000111000110011000011011000011101001010101000001000000010101001100100101010001101101010111100000111
1010000100111010010101101000101011001001001001010000000000110001100011000001100110110001110111110001001100101000101101100001000000000000110100100111111010110100101000110001101001111000111011110000100110101100001010001001110110100110011101111001111100000111
0011110001111011010001110010111011011001001101110000000000010101101011010100001011100011110111111001110000011010101100000001000101011100010000001100100011010000111010100011001011001000000100001000111000001000100010111000001100110010101010101010110100100111
1010010100111110110101100000101011001000001001000000001100110001100001000001000000110011111101100001001100100000111101101101000001010010110101100110111011100100100011110001101001101100011011110001100100101100000110001000110110110001011111101001111001000111
0110110111111110001001011011010100111100100111110001100000001100001110100000111110010000001100001000110111110010101000000000000100100000000000011101010010011010111000000110010011001010110110101010101100001010010010111101101111101110000100001111001101011001
0110011001111111010101101110111100011000000101111000011100010101001000100110101110101011110111000001010101111111111110100100100100011000101000101110011011010110100010100101111001101000011101001011001111101001000110001010001110110000001010000011110111010111
0000010001100011000101110110111110001001000101101000011000010101101001100100001010110011110101111001010000010010011100000101000101011000011000000100000011010010111010101001001001000000000100001111111010001000100110001000000100110000101010100000110011000111
1010010100100111110101100000101011001000100001000000001100100011100001100000000100110001110001110001001110000010100101111001000001010000110100100110111011100100100010100001101001101100011011111001110110101100001100001000110110100101011101000000110011000111
0100001111000000101101001000111100010110101010001111001011111111010011011111011010000100111000000010011000100101010100100010001101111111000000000000000101101010100001100000001010000001001100100001011100100011000100000111000010010101001000000101110011101100
0000011001110111010101100110110110001000000101111000111100010111001000100110001110111011110111000001010000101111101110100100100100011000101000101110000001100010110110100001001001101001011101001011001011101001000100001010001110110000010010000011110111010111
1000011001100011010101000110110010001010000101111000111100010111001000100110001110101011110110000001010000001010001110110101110100011000101000100110000011101010110100100001001000100001011100001011011001101000100110001000001100110000000010000010110111000110
0000111001111001000101010110110110000001100101111000000000011101101010000100101011100111110100011001111000010010011110000101110101011001001000000100000111110110100110101101111001000001001100001011111010001000100110001000000100110010001010100011110001000111
0000110001111011100001010100110110001001100101011000000000010101101010000000001111110101110000011000111010010010010100100101100101011000001000000100000011110110100010001111111001000000011100001011111000001010101110101000100100000111001000100010110001000111
0010111001010011110001010100111110001000000101000000001100000111100000000000001111110101011000000000110110001010110100101101100101011000001001101100011011100110100010001111111001101100011111001011111011100000001100001000101110100101011000100010110111010111
1010011000100001110101000100111011001010010001000000011100111011110001000000000100110101110001110101011100000010100101111001100001010011111101101110111111100100110111100001101000101100011011010011010110101100000100000000110010110001011110100000110011000110
1101000100111110000100101011001011001000101001111010100100010000111000011000100000010001101111010000010001000000101001001000010010000010110100111011010000010000011001111000000111110011110011110110100000001100010010111001010100110010100111111010001100101011
1110010010100011100101101101000011001010011001000100000100000010100110000100000110111111010110110101011100100000100000011110010000011000111101110010111000100100000110010001100010111101001011110110110100001101011000011001110110110110010101101010010000001111
0010110001100101000101010100110110001011100100001000000100010111100010000000001111010111110000011000110010010011010110101101101101101000001001000100001011001110100100001100111011000100011100001011011011001010101100001000000100000101001000100010110101000110
1111101110001110100001100000000001001111001000010010011000000000000101111011100101010011010011100111001101011100000011010000000000010100010100111001111010000101010011010111110100011010110011110100100000010100011100011110110111000000000101011101001010111110
1011110100111010000000010111011010110101110001100011000011001100101100101100101101001111000111011001110001010011101010001011100010000010001100001101000000010000111000001010000101001000100100101010101000001000001010111001001101101010000110101010101100000011
1000011001100001111101000100111011000010110111001001000111111111100010100000001110100100110101100100011000000001101100010001100001111011111100101110101101100100101111100000101110100110011101001001011011101010000100000010010010110001011010110000110011010101
1000001101000000110101001011001011000111010000101010000111110010100011010000000000000101111101100110010000100000101001010001001001110011110101101010101110000000011101110000001110110100100101110001010100110111000100010000010010010011111010110001111010000110
0010111111111010111011010001111110001100100010011000110011111101111100100100111101001101010000011000110111110001010010001011101101011010000001000100011000011110100101100110111001000000101101001011011111111011111100101000100111101111001000111011100101000101
1110101010001101010110100110000011100001001101110000111100010000010001110011000110111011110101100110011001011101101101010000100010010111110100101011111101100101011011110011101100111100011001010000000001000101001110000110010100010000011111000101111010111011
0010110001111011001000110100110110111001101011011101100101010101101100101100011111101010000110001001111010011000011010001011000110011110001000010100000001111011000010001111110001010000001100100010111001011000111010101000000001100110001000101010000101010001
0011010001110011001000010100010110111001101001000111000101000110101110101100011100101010000010001001100010010100110010001011000111101100001000010100000001101010001010001111010001010100001100001111111000010000011000111000101101100110011000100010000101111001
0001111001110011001000110111000110111001101011101111110101011110100000101100011101101010100010001001101000011000010000001111001100011010001000010100000000101011100000111111010001010000001100001010111001011100111010111000000001100010001010101000000100010001
1100101011000101010011100100100001000000001101011100111000010010000001110111000011100011110111101111001001001111101101010000110000010111010100001011111111100001011011110011101100100110001101010001000001000100101110100110010000010000011111000101011010111111
0000011110100000001000001001000100000010000010011000100001001110011010001000001000010110000000000000000000000001010000101011001101101001000000000000000100001010010100000000000010011000001000101011011011001110000000010001001010001011100000100110000111001000
1000111110000000101100011011011000110011100010110000110010111110001100101110111011010010100011011111000000101001000001011111011010110001000101001011010111001010110101000010001010111000101101001111011101010010101100110011101001011000110010110110010111001000
1100101011000101110111110110101001000010001101001100111100110011000001110111000011000011110101101111001001001111001111010100110000010111010100001011111111100000010011110010101100111110011101010001000001000100101110000110010000001000010111000101011011111111
0001001000010111101100100010110100111001100110111111111001111111101100101110111000101010100011010011000001001001010101000011100010010010100101101111010000001010110001100011001001101001110101001010000011000000100100001010001000011000000010110110110111000000
1001000110000010111000000000101000100110001010011011100011100010000011011001100000000100001010000110001100100000010001101010011011100011100101100010011111101100010001110000101110110000001001111000100100000111000100110000011011111111110110110100001111001000
0111001011011101111000110010110101110001101010110001111101111101001001111111011100100010100011100011001011001111100101000000110110011111010001101010001001011000110001001011001101101001011100001001001011000000000110000110101001011100010100010101101111111001
0010100111011010111011000110110100101010110111111000000110001101101110000000111111110110100100011100100100100010001110101111011111101000101000000000001111011010110000000100011011100000101100101110111110001011111010001000000010101111100110111111010101000000
1010001110000000111100010000101000100010000010001010110111111011010001111101100000001100010011010110001111000001010001010000100011010011100101100010111101100101010101101000111100110110001001010001100001100110001100000110010001001101010110110101001011011000
1100011000100111100000100100101001101110110010000101111000100011000100100110011000110000000010110100001110001001000100010000001010101000111101110110111111101100100110000001101000101110011011011011000001111110010100000010110100111101010101000100000011000011
1100010110000101010110001001000001100010001100011000000000010010010011100011000010010101101110111101101001110110011000110100100010100101110100000000100111100100000000110100110110010011011011110001110110100101110010110111010010111010000111010001010001101011
0100001010010101101000111100010100100100111010000101011000001110001100010111011100010100001000101010100111100111010000100000101111001100001000010001010011100110000010010110111001000101011011000001000100110000111100111111101001011101010000000111000110101000
0010110101111010111010000000110110101000100111011001000110001101001110000000101111100110000000010000100110100010110010100101011111101000101001100000011011111110000001000100111011100000001100101111111100001011011010001000100010101111110000110011010101010001
1000111110100011101100000001111000101110100110001101100100101011111100100000111110011100000000010000000111101011010001101111111011010000000101000010011000001111110101000001111001100100100011011111010111111011111100001000101010110111010000111010010111010010
0111001010000101001000111100100100100111111010000001111001001110001100111111011000010110001000111110100111001101010100110100101000011100001101011101010111001110110110000110110000001100011011000100000001010010011100100111101111001101011001000110000111101000
1010011100111011101100001001001010101110110010000000110011101111101100100000111000010100001000000100100111101001000001110011101011101010100101100100011001111110110101000100110000111100001011101011010111111111011000111001100001111111010100111010000101000000
1010111000000001100011101101101011000110110000000000111000101011000100101110111000010011000010110111101110001001100100110011001000110001001101110110111111101100110110000001101100111110011011011011000001001110010100010011111110001100011101100010000011000010
0101001110011100111100100010011100010000100010111011111001101100001000111011111000000110000000011010000001001101000101000100110100011110100001000111001001011110100001000000100101100001110100001100001011000000101110101110001011011000001010010110100111101000
1011011000000000000010110101000010001101110000000011111010101011100100100010100000010010010010110111100111001001110100111011001000110000001100111111111100001110111110000011101100101110110011011011000001001110010100010100111110001100011001101010001011000111
1001101101100010100001001011001000001010110001100010000010110011111010001000110001001101111111010100010000100000001011111011011001110010000101111110001100001001111011100010001110111111100001111011100100111111101100111001011000100011110111111110001000010110
0101100110011100111000010011011110010100001010111010100011001100001010011011111001000100001010011011100011110100010011100000001011100111000001001001010110010011110000100110010111001010100100101000101110110011101010111110001001101110100110011111101100111000
1011110110011010101101111111111010011111110011100111000010101101111010001000111001011100111011000100010100100000101011101011001001110000001101111110011100011001111000100010001110101110100011101011100110110011001100011100101110100011011100110010110111010100
1001111110111010100101111011001011001010110101100111000010110001111010001000111011011101111111000100010100100000001011101011001001110010011101111110011000011101111001100010001110101111100011111011000100111011000100011100001100101011110111111110011101010110
0011011010010010001000100101000100101101110011000111110011000010011100101010111000011010000000100001100111001001110000001011100010011000001100010101010000001110100111001011101001011100101011011011000001101001010100011110101001001101001001100110000111000001
0110010011000001111010010100110101100111011001000101001100001111110011010011011011101110100000000100101110010110110101011110010111101101011001000000111101100111000111001110111010100100001100100001111000010011001000100110110000100100111000000101000001111010
1000011010000101111110001100111001100110110011000101001100111111010010000011011000001100001001100110001100100101110111110011110011011011111101100110110101101100100111101000101100101101001101101001010100110001000100000111110001010101011000100101100011000000
0110110001111010001000011011010010111000100111111000000100000100001110000000101101001100001100001000100010110010101000101100001011100000000100010000001000010010010000001100010011010010100100101011111100111111011010111000001011100011110111011010001100001001
0000111110111011101100100000110100101101100110011101111000101101011100100110111110010010100010010001000111001001010111001111111110011000100001010110010001011111100101001101111001100001101010001011001111011011111100001110101000011100010000110110010111010000
1001010010100001000000100101001001101010010000000010110001000010110100101000100001111001001001111100000100101000000001011011101010100011011100011011110100001100010111011011100000011100100011011110110001101111010000110100110101101011000101101111001000000010
0010110001111010000000011011000110111000101001111001000010010000101110001100101111001101101110011000100100110000101000101011001110101000000000011101011000010010010000111100010011011010100100100010111110101101111010111101001011100011110011111010011100100001
1000001000000101101110000101001001100010011001000011111001111010100101111111000000010011100001110111001101001001110101010101110010010111111101100110111100101100000111110000101100111110011011010001000001010100011100010110110000011100010101100101001010100000
1001100110111010101110101010100100101000000010111010000001100001101111010000110001010101001100011000000010100000011101100011011011100010000101000101000010011010110001101100100011000010100011111010100100101010111010101001000011111011100110111110001100000011
1110010111111010001000010011011010111001000011110000000110010100001010000100101010100010111111001001010000110010101000001100010100100000000000001011000010010000011001001010000011011000101100101010111110001000000010111001101000110010010100011111001101011001
1011100100110011000000111010100000101100000000111010000001000011100111011101100101110000001110011000101000110000011001100111000011100010000101000000001001101000100011010101011011010000000010111100100110101111111010101101010011100011100111111100001101000001
1100010111111110001000101011011001101001100010110001000000000101001110000000111000110100011101010000000100000010101000000000010010100000010101111010010011011100111000001010010011101001011101101010111000001000010010101001101001110110100100011111100101001001
1000110110111111101000101010111000101000000000110001000000100101001100000000101001110101001001011000000100000000000001100001001011100010110100001110010011011100110001101010100011001001011011111010110100101010110010101001111111110011100110111110101101000001
1011111100100110101000000001001000111111110010000011110011101010011100101000111001111010000011010101000100101001100011010001001010100010100101111111011100001001110101001011000000101101110011011010110001001011011000110100101011101010011100111110001100000000
0100010111111110101000111011011001111001100001110001000001100100011010001010101000100100011111011000010110010100001010001000010100001000010001110011010010110100001000001110100011011001011100101110111000001000000010111001101101110110010100011111100101101001
1011100100100010000110000011000011100111110000110010100111100010101111101000100001011010001011010101000100110000100011011011001010100011110101111011111100001101010001110010000110111010100011010010110000011111011000010001010001100010100111111000001000010000
1111011010100100101011010100101001000010110010000111111111100011000101101111010001000010010011110111001101011001000011010000100000010011011101111010111100101101110011110010000110001110110011011101000001011000000100000100110001001000000110001100001010011100
1011000100100010000100011011000011100111011001111010000111110010100011011101100001000111001111100101001000110000101011011011001010100111010100111011111110100001010001111010000110110010100011110100110100011111010000010001010001100010100111111000001000110000
1011000100001010000000111011000011011111001001110010000111010000100111011101100000000110001111100011011001010000101001001010001000100110010100111011101000010001011001110010000110111010100001110100110000010100010010111001010101101010110111111000001000111000
1111101010001100000111110111011001010000001101100110111011010100001001111111101001110011110111110111010101011111101010110000100000010111010100111011111010010000011010111011000100011100110111001000000001000000000110010110111100001000010101000111011010101111
1001000000011110110000100011011000011001100001110011011000001000001100110100111000110010010111000001000101001010001110000001010010000000010101101111011000011001110000100011000001101000110011011010100000000000000010011100101111110010010110011111101101010011
1111111111111110010011110011011001011001000101110110111001010100001000100100100011100011110111111001110001011011101010000000100000010010010100001001100010010000011010011011000001001001100100001010001001001100000010111100010100100010010111011111111010001111
0001000100011000101000100011001110010000101000111010000011110000101011111011100000001000110010010011010001001100010000000000100100010111000001100011000010010010000000110001000111110010100100100100001010000100000010110010001010011000000110011000001100101000
0010011011011111011000111000110000001001100010000001011000111101001000000110111000100010110111100001010100010010101100000000100000011000000100100110011001111110101011001001101001101101011101001011001010001000000110101111101000110000000000000111100111001001
0010001101011000100100100011000100000001001100100000100100110100001010100011001110000010100010010001000000001100000000000100000100101100000001100011000100010110000100010011000011001010101100100110001001010010000000011010101000110000110000011010000010100000
