1001010000001100010000010101110011010111010100000010001100000101001110101010101000010111010000101101110110000000000100010001010011100001011101001100110111011100111110000110011110001111110011111011010000010000110100101000101101010100101101100011100011000010
1110011000001100100001010100110010010100010101000000001010001101001110000110101010010101010000000100110110000111100100110000001001110000001101111100010011010111111110000110011010101100111011101011010001110010000100001010101110010101111101000011100011001110
0101011001100100010000010110110110011111011000100010111101000101101101111001001000000011010111001101111010011100001100010001001110111100001000001100100111010010111110010111011010001101010100001001111001010011100100100011101101111000101000000001100000100010
1100111000100110100111000100101011001010110101000000101010100011100010100100100111010111110001101100010110000011100110110101010001110000111101110110111011100101110110100000101110101110111011111011010001111100001100001000110110110111011101001011111011010110
1000011000101110110000001101000011001111010000000000000100100011100110000000100010010101011000101100111101000001000100010101110001010000011101000100110010100100110110010100111100011111111011111111010001011100110100111000110100110111001101101001101001000011
1100111001111110100101000100111011001100110101000000101010100101101010100100101111010111110000000100010110000011100110110100010000110000111101110110110011110101110110000000101110101110111011111111010001111010000100001000111110110101111101001011110011000111
0110001001011100100101000100110110000100110101000001101000001101001010010110101110010100100000010010110110000111100100100100001100111100101001110101010011010111001110001100111011101100011110100011001001110010010110001010100110010101111001000010110111101111
0100001001010111100101000100110110001100110101000101101000011101001010100111111110010110100000010000111110001111110100000100011100111100101001110100011011100110000110001000101011101100011110100111001001110010010100001010100110011101111001000010010111001011
0100011001011001100001010100110110000101110100000000101100001101101010100100101110010010110000001001110110000011000100000100001101111000001000000100010011010110101110000110111011001111011100101111011001110010100110001010101100010100101000000011110111010111
0000111001100001100101000100111010001010010100001100101100110111100100100111001110010011100010010101011100001111010100011110010100111000101101110010111101101110000110101000101010100100011111100111011001011010111100000010110100111100101011100010010011000011
0000011001010001100101100100110110001110110110001001101100111111010100100111011110010010100000010011011111001111010100001110011101111100101001110110001001101110100110001000101011100100011110100101001001010010010100001010100100011101111001100010010111000110
0100011001111011100101010100110100001101110100000001101100011111001010100000001010000100110000001000110111000011010100000100001101111000101001000000010001100110101110000100111011001101011100101111011001111010100100001010100100010101100000000010110111010111
0000011001100111100111000100110010001111010100000000101100110111100000100000001110100100110000001100111110000011000100010100001101111000001101000100110001100110100110001100111010001101011101101111011001111010100100001000100100111101101000000010110011010111
1011100001011110010001111011011010011000000011110010111100010100101000111100101011010011111111010001110001111010101011000001100000010010000100101101010010011001111001000010000101001000110101011010100100101001001010111001101110101010000100111011101100010100
1011100100011010110000111011001010110001000101110010000001100000101111011000100101110001001111011011000100011000101100001001000010100000000100001111011010011000111000011011000011011000100011111000100000000000011010111001101111100010011100111011101100100001
1011100100111010000101101011001010001000001001110010000010100000101011011000100101110011011111000001000100101010101000100001000000100000110100111011011010010000011000110001000011111000110011110010100110001100011010011001010110100010110111111000011100100110
1011100100011110000001111011001010111000000101110010000000100000101110011000100101110101001111010011000100011000101000100001000010010000010101111111011010011000111000010011001001111000100011111010100110100100011010011001101111100010111101111011101100100010
1011100101111010010000111010111011111001000001100010000001000101001101011000100001100001001111111011110000010000101000001001000010000010010100001101000010010000111000001011000001001000110100011010101000001000010010101001111101100010101100111001101101000011
1011000001111011010000110010011011011001001001110010010001010100101010011100101000000011110111111001110000011110101110001001000000000110010100001101110011010000111000101011000011001000011101001110101000001000000010111001011101100010001110101010101101100111
1110000100111010010101100010001011001001001001110000000100110000100011010001100110110001111111110011001100001100101101100100000000000110110100101011111010110100011001110001100011111000011001110000100110100100001010011010010010100010011111111001011100100111
0011010001111011010101110010101111011001000101100010010101010101101001101100001010100011110111101001011000011010101100000001000100011000010000101100100010111000101010110011001001001100010100001110111000001000000010101000100100101010001100101000111100000111
1010000100111010010101100000101011001001001001010000000100110001100011010001000100110001111111110010001100001100101101100101000000000110110101100111111010110100001011110001101001111100011011110000100110001100001010001001110110100010011101111001111100100111
0000010001111011010101110110111110011001000101101000011100010101101001100100000010100011110101101001010000010010111100000101000101010000111000000100000011011010101010101001001001000100010100001111111010001000100110001000000100110010001010101000110001000111
1010000100100111110101101000101011001000001001000000001100110001100001010001000100110001110101100010001100000000111101111001010001010010110100100110111011100100100011110001101001101100011011010001110110100100001110000000110110100001011101101001111000000111
0101000111011110011010111011010100111000001111111110100101010100001100011010101010000000001111011001100001110100001001000100000110101110000000000001000010010010001001010100010001010011110100100110101100100000110010111111001010111010000010001111111100101001
1110010100100101110101100100101011001010000001000000011100110011100001000001000100110101110001100100011100000010100101111001100001010011111101101110111111100100100011100001101000101100011011011001110000101100001100000000110110100001011101000000110011000111
0010110001110011110001010100110110001000100101000000001000010101101010000000001111110101110000011000111010010010010100100101110101011000001000000100000011110110101010001111111001000100001100001011011001101010101100101000100110100101001000100010110101000111
1010011001100001110101000100111011000011110001000000011100111011100001000000000100110101110101100100011100000011101101111001100001010011111101101110111111100100111111100001101000101100011001010001010011101000000100000000010000110001011110000000110011000110
1001000100111010000110101011001011001001101001111010010100010000111001011000100000010101111111100000010001100000101001001001011010000010110100111011011000010000011001111000000101111001110011010010100100101101010010011001010111111010010111111010011000110011
1110110010000001100101001101000011001011011001001100000100100010000111000101000110110111110010110101011100000110110000011110010001001101111101110011111110100100000110010001100000110101001011110000110000000101011000010001110110110110110101001101010000101111
0001110001110011001100110111000110111001101011111011010001011110100010101100011011101010100010001001101010011000010001001111001110111010001000010100000001101011100001111101110011010000001100000111111011001100110010111000000001110110001010101000010100010001
0001100000000001000000010111000110110111101000101011000101000010101111111100010000101011000010001001110000011000010001001011001111111011001000010101000110001010100101011111010011010000100000011000111010010110110000110000001001110110101011101000001100110000
1001001001010111111000100010110000111011100010110011111101101111001000101110111000100010000001010000000101001001000111000001111010010010000101101111010000001010110001101011001001101001110101001010001011001010000100101110101001010000010110110110100111000000
0000011111000000101100010010111100110110010010100101101110110111001010100100111110011110100001000101000101111011000101101110011010111001000001001000011101001011110101000000011110001010101100001011011101011011100100000111101010011000000000110110010111011000
0000111101111010101000000001011100111100100010000001100010101101111100100000111100011100001000011000100111101011000001100111111011101000100001001100011001011110110101000100111001001100101111101111001111111011111100111000101001011111010000110010000111000001
1010110100101010101000000001001011101110110010000000110011100011100100100100011000011000001000000100100111101001100001111011001011100010110101100010111011101100010101000100110010111100001011011011110111111111011000111001111011111111010100111010000101001001
0011001000000100000010110101110100110111110000000011111110001011001100111010111000010010000010101111100111011001010100110001101000010001001100011101110110001110110110000111011100001110110011011111000001000010010100100110101111001100011001100110100111000010
1000011011000100111110001100111001100010110011000101001110111111110010000011011000001100101001100110001101100001100111110011010011011011111101101110110101101100100111101010101100101111001101101001011101110001000100000110110001010001010000100101100011010000
0001000110111010100100111011001100111000100001111111000011101000101110011000110000011100001101011000100000100000111001100111011011100010100000000111000000011010111001111000000011100001100010111110100110001010010010011101001111110011110110111110101100000011
1100010111111110101000011011011000011000000111110100000110000100001010000000101010000110101101001001010000100010101000001000010000100000010100101010010010010000011000001010000011001000101100101010111100011000000010111001101001110010110100011111001101011001
1100010111111110001000001010011000111001000011110101000110000101001010000000111000010000001101000000010100000010101000100000011000100000010100101010010011011000011000001010000011001000101101101010111100001000000010101001101001110010100100011111001101001001
1011100100100000101100000001000010110111010000000010110011100010101111101100100001010010000011010101000100001000100011011011001010100011100101111011111110001101010101110000000110111111100011011110110000001110011000010001011001100010110111111010001000000000
1000110110111111001000101010111001101000000010110000000000100101001110000000111000110100001001011000000100100010000001100001001011100010110100001110010011011100110000001011110011001001011011111011110100101000110000101001111111110011100110111110001101000001
1001011010100000100000010111001001000011011000000111111111100010000011111111000001001011010011110111001101011001001011011010100000000011011101111011111100100001010011110010000110011110100011010101110001011100000000010100010001001000000111010000001000111110
1000110000111111001000101011011001101000000010010000000000100101010110000000011001110111011001011000010100100010000000100001010011000010010101011110110011111100110000001011110001001001011011101011110110001001110000101001111111110011100100110111100101000001
1101000110001010011010110011001001110101001000110010010011110000001001111101100001001110000111111111001001010001001011000000100000000111010100001001100100010001011001110110010100011010100100010100100010010101100010110100010011001010000110011101101000111000
1111000110011010000000111011000001111101001001111010000111010000010111011011100000000101001111100010001001010100101011100000001010100111010100111011001110010001011001111010000111110010100000110100100000010100010010011011010001001010110111011101001100110000
1111000100001010000000111011000011111101001001110010000111000000010111011001100001000111001111100111001001010000101011001000001010100111010100111011111000010001011001111010000110111010100011110100100000010100010010110001010001101010111111011001001000111000
1011000000011110010000100011011000111001100001110010000101001000001100101100101000111011000111000001010101001000101000000001110010000010000100101111011000010001110000101011000001101000110011011010100010001000001010111100001111110010010110011111101100010011
1000010000111011110001101010101011001001100001110011010000001001101101100100110000111000001011000001001000001000001100000011010000010010011101101110011000011001110000110111000001101000110011011010100000001100000010001001010100110010010110111000101101010111
1000010000111011111101101010100011001001100011110101011000101001100101000100110100111000001111000000001100001010001100000011010000010000010101101110111001111101111000100011101001101001111011011010110010001000000110001001110100110010010110111000101101010011
0110100011011111011011110010110100011001000110100001011100101101001000100010111111100010110110111001110111010110101100000100100100001100000000001001010001010111001010001011000001001101011100001010111010000000001010101111101000100100000000000111110101101101
1010011101111111011000101000110001001101100010000001011100101101000000000110011100100010000111100001010100010010101100010001100000011000110100100110111001101110101110001011101001101101011101001011011010001000000110001101101001110000000000100110100011000001
