0101010011000100111000010110110111110111011010100010101101000100001110111111011000000011000111101111110010010100001100010000000111111101001001001100100111001010111110000110011110001111010110101001111000010000110000100010101111110000101000000011100001111000
1001011000001100110000000101100011110111010000000010000100000001001110001000111000010101001000101100110110000001000100010001000001000001011101001100110110001100111110000110011110001111110011111111010000011010110100111000101111010111101101100011100011010010
1001011000101010110001001101000011000111010100000000000100100011101110000000100000010101001000101100110101000001000000110001100001010001011101001100110110001100110110000110111100011111110011111111010001011100110100111000110110110111001101101011001011000010
0101011111000100101000010110110100110110001110100000001110000101001110011011011110000100010100011010111000010111001100100000001111111101000001011000000111010010011100000110011010001000011100101001011000110010111100100110101101000001101000010111100111101000
1010011010001100101001010100110000010110010111000000101010000101001110000010111110010101010000010000110110000111100100110000000001110000001101011100010111011010111100000110011010001100110011101111010001110010010100001010101101010101110000000111100111001100
1010011000101110100001000101110000000110010111000000101000100101001110000100111010010101010000010100110110000011100100110001011001110001101101111110110111011101111110000010101110101110110011111111010001111010010100001000101100011101111101100010000011000110
0111001000011100000001010101010110010100010101000000101010000100001110111110101110010101010000001010110110011101110110000100001100111000001000000101010010010111101110000110110011001110110110101111001001110010010110011010101110011101110001000011110111101111
0000111000100110100101000101001010001100010100000000100010101011100010100100101011010111110010010001010110001011000000010101001000111000101101100110010010100110100110000000100011101110011011111110000001011110100100011000111110111110100001001011110011000111
0000011001011111100101010100110110001101110100000001001100010101101010100100111110010110110000001001110111010011010100000101001101011000001000010100010001011110100010000100111001001100011100101111001100010000100100001110100100010100101000100010110111000111
1000011001100011100001100100110010001111010100000000111100010111100000000100001010110001110000001100111110001011000100111111001001111000001100010100110001100100100110000100111010001101001101101111011001111010100100001010110100111101101000100010110011000111
0100011111000000100101000000111001001010000100011000111110110111000000100011001110011011100100101101011001101011011100110100111101111000110001000010101101100110000110100101111100100001001100000001011101110011101110000010000010011001001010010100110011000011
0100001001011110100100100100110110001110111010001001111110011101001000100111111110010010110010011000101111001111100100000100110110011100101001010100010001110110000000001100111001100100011011100111001011010100100100001110100000011100011000000010010111101110
0100011001110011100100100100111010001110110010001001111100110111010000100111001110110010100010010101001111001111010101011100011100111100101101110010011001101110000010001001101000100101011111000111001011001010100100001010110000111100011000000000010111000010
0100011000100011101100000100111111101011010000001001111100110111010111100111001110010010100010011101001100001100010100011110011101111100111001000010101101101100100010001101111010100111011101100101111001001010111100000010010000111100101010100000010011000000
0000010001110000100101000100110100001110010100001000000100110111100010000000001110010101111000011000011110000010010000100111011101101000100001010010010101100110000100000100100110100110001010101111111000011010110000001000100100111111110001100010010001000110
0000010010110100100101001000110100001111010100001000000110100111001110000100001110010101111000011000010110000010010000000101011101101000100001010110010111101110100100000100110011100001001010101111111000011010110000001101100100111110110001011111010101000110
0000010101110000100111001100110100001110010100001000000110110111100010000000001110010101111000011000011110000010010000100111011101101000101001010010010111100110000100000100111010100110011011100111111000011110100000001001100100111111110001000010010101000110
1011110000111010000111011111000010001100010101000110100100000000101100000100100101011101011101000000110110010000101000001011001000100000101100111101011000011100111010000010100011001110100011111110110000001100011010011000100110101011100101101010001100000111
1000010001100011010000000110110111001001000000001000011000000101101001000100000010110011000100100001000000000010010100100101000101010000001000000100000011000000111010001001001001000000001110001011111010001000000110000000000100100000001100100000100011000011
1010110010110011000101101101000011001000110101000001000100000011100110000100001110111011010010000001011110000000100000011111010000011000111100110010111000100101001010000000100011111101001011110110110000001101011000011001110110110110110001101010010101000111
0000011001111001000000000000110111000001000000010000000000000101100010000000001000100111000000000000001000000010010100100001101101011001010000000100000111110100100100001001101001000000001000001011011011001010000110001000000000100011000100100011100101000010
1001101000011110100000100101000011101101111000000111011000001000001101111011110101011010000010100011100101101000000111000000100010010100011100011101111000011101111001011011000100111100110011010100000000000100011100011110110101000000011101001000001010110010
1011101000011110100000100101000011101111111000000111011000100000000101111111100101011010010010100011001101101000000111010011000010010100011101011111111000001101110011011001100000111100110011110100000000010100011100011100110101001000011101101000001010010110
1011110100101010010010010111011011010111110001100010110001001100101100101100101001001011000111111101110000010000101010011011000000100010011100001101100000010001111000000010000110001010100100001010101000001010001010111001001101100010000110101010101000000010
1110100010100001100101000100000011000011011001001100000100100010100111010101000110111111010010110101011110100100110000111110010000100101111101010011111110100100000110010001100000110100100011110100110110001111111000000001110100110110111001001000011000101111
0000001001011110011101100111010100111000100111111001111100011101001000100110111010010010100111010011000001101011101101100101000100011000101000000111000000011010111000101001000001100011110110001010001101100001100110001010001010011000000010101110011111000101
1010011000101001000110110101001011000011011001000000110100000001100001100101000100110011110111100101001100011001101001011011100010000001111100111010111101100100011011110011101000111101001011010001010001111100010100010000110100110010010101100000011001000111
0001110001110011101000110101000110111001101011011011010001011110100010101100011001101010100010011001001000011000010011001011011110111110001001010100000000101011100001110111110001010001001100000011111001001100110000111001000000110110001010101000000100100001
1100100011100001110111010100101011000011001101000100111000110010110011110101000011010011110111110111001000001110001011011110110000110111011101001010111101100101010011110010101110011110001001010000110000000110101000000010010010101000110111000001011000101111
0011001011010111111000101010110100110000100010110111111101101111001000011010111000100000001011000010000111101111100111100000110010010010000001101111011011001011110001101011001001101001110101001010001111100001000100101111101001001100010000010110100111111000
1001000000100001001000010011100010110111100010111011110101111011101101111100110000101010000011011101010000011000011001011011001000110011000101011100000110001000110001110101011000000001100000011010110011001010110000100000011100110010100110111000001100000000
0001100000100001000000010111000110110111110000111010100101000010101111111100110000101011000111001111110000010000001000011011001111110011001000011101000110011010111000110111011010010000100000011000110010000010110000110000001101110010101111111000001100000000
1000111000101111100000000100100011101110110000000101111011101011100110100111011100010010000010100101101110001000000100010001011000111000011101110100111011100100101010001001100110111110011011011011110001111110011100000011110101110100110101100000000011000011
0100101010011111011000111100000100101100011000000110011001001100001100010111001001000100001100111010111111010101010100000100101110011110001000000001010011110110001010010100110001010100011010000000001010000010110110111111100101011101001000000111100110101011
1010011000100001100000000100110001100110110010000101111000100011100101100110110000110011000010100101100110001011110100011011000000110001001100011100111101001110110110000011100110101110111011011111010001011110011100000010110111000100111001101000001011000010
1010001000100000100000000100101011000111010000000100101010100011100111110101100100110011010010110101001100001011100100011011000000010001011101111011111101101100010110000001101110101110101011110101110001011100011100000000110100000000111101101000001011000110
0100001010000100111000110100110100100111111010000001011001001110001101010111011010110110000010011010101111011101000101100100100110011101001001001001010111000010011001000111010000001100011110000100001001000000110100100110100011000000001000000101100111101000
0110011001000100011010011100110001100110010001000001001100001111010010000011001010011100111000100110101110100110110101110110000111011101111101100110111101100100100111001010101110101110011101100001011100110001001100000111110000010101111000000101100011010000
1010011001000100011110001100111001100110010011000101001110111111110010000011011000001100101001100110001111100011110111110011110011011011111100100110111101101101101111001000101100101111001101101001011100110011001100000111110001010101011000100101100011010000
0000011101111010101111100000110100101101100110001101111010101111101100100100111110111010100010000001000110001011010100001111011100111000100001010110010001111110100100001101111001100001001011001011000011011010111100001100100000111110000000101110010111000000
1011010010100011000000110101000000101110010001000110110000000010111100101000110000111001001000100100100110101001100011011011001011100000001101111101110100001100111111001011100000011100100011011110110001101111010000111100111001101111010101101010001000000000
1011111110100000101000000001001000111111010000000010110011100010001100101100100001011011000010010101000110001001000011011011011010100010000101101011011100001011110101010010000000111101100011011010110011001011011000110001111001101110010001111010001100001000
1011110100100000100000000001001000110111010000000010110011100010011110101100100001010011000010010101000100001000100011011001001010100011000101111011111100000001010101010010000010111101100011011010110001001110011000110001111001101010110101111111001000000000
1011100100101010100010000011001001100111010000000010110011100000011110101000100001010011001011010101000100000000100011011000001010100011010101111011111100010101011001010010000110111111100011011010110000001110011000111101111001100010110101011111001000000000
1111100100100010000100001011000011100111011001111010000011110010000111011001100001001111001011110110001001110100111011010000001010100111010100111011111110000001010001111000000110110010110011110100100100011111011000010001010011100010100111011000001000111000
1111000110000100001000110011011001010111001010110011011011101000010001011111110001001110001111110111000001110100101111110000100000000111010101101011110100000001011001110111010100001011110101010100000100010001000010110110011001001000000110011101101010111000
1001001010001010000000100001010001010000000000000110111001000100001001111110110000110011000010100111000101001101000000010010100000010001011100001001110000011000011010000001000000001000100001011000000001000000000110011110011000001000000101000111001011101001
1001001010111011000000100001000001010001000000000110110000000000001000101010100000100011000010100101000000001001000000000011000000010000010100000001100010010000010010000001000001010000100000001010000001001100000100011100011000000010000100001111001011001001
1111001110011010000000111011001011110001001001110010011111000000001101011111100000100001001111100011010001010100101100100000000000010111010100111011101000010001011000110011000101111010110000110100000100010100010010111111011100001000110111011001001110111011
1101001000001101000000110111000001010000011100111010111001000000000101111111000010110010000111100111101001001101001000110000100000010101111100001001100100010000011010010111010100011010110010010000000011000100000110010010011001001000001111000100001010100011
