1000011010000100001000000100110000010110110010000101101010001111001010000110011000011100000000000000010110000111000100110000001001111001001100011100010101001010110110000010001110001110011111101111011001100010000100001110101100001101101000000110100011001000
0101011111011100101000010110110100010110111110100001111011001100001100011111011010000100000100000010110010000111001100000100001101111101000000011100000111011010101100000110011000001100011100101101011001000010000100010110101001001001101000000111100110101000
1000011000101010000000000001100011001010100000000100100010000011100010100100101000000111000000000100000000001011000000011011001001110000010100000000100011101000110110000000100110000010001001111111010001001110000100001000010000100011100100101010000001000010
0001001000010110001000000101000100010000010010000010101010000100001000101110111010010111000110000010000111001001010100000101001100111000001000010101010010011110101010000000000011000100110010101110001001000010000110011110101110001100100000100110000111000001
0001001010011110000000100110010100010100010010110010101001000100001000111010101000010011000010000010010111001101010100000000001100011000001001011101010010011010110000000000000001000010110010101110000001000000000100001010101110001100100000000111100111001000
1100011000100110000000000000110011001011000000000000111010000011100000100100100000100011000010000101001000001000000100010000001000110000010100000100100011100000110110000001100000000000011000000111110011001100000100001000010010101010001100001001000101000000
0100001101011111010000100000110110000101001000000000111000000101001000110111101010010001000010000010010111001111010100000100100100011100000000000001010011010110000000000001100001000000011110000010001011100000000110001010100100001100001001000011100111101010
0100011000000101000000100000110110001011100000000000111000001111000000100111001000100010000010000101001000001111010100010000001100111100000100000100000001100010000110001001101000000000011001000011000001000010000100001010010000101000001000000000100111001010
