1101001100011010011101100011001011011001101001111010010111110000001001111011100000000011110111100011001001001100001011001000101000000110110100101011001010010000011001110001000101110011100000010100100100010100000010011010010010001000000110011001001110111001
0101001101011010010000110011001110011001001000111010011111010000001001111011100000000010100111001011010001011100011010000000001100000110000000011001000010010010010001110101010001010000100100010100101110010100110010111010001111001000000110011000101100111001
0001010100110010101100001111010110010110110010111011100000101110111110001000111000011110001010000000000100100000010000001011011000100010101001111111011100001011110100100100010110100011100010101110100000011011110000011001001101111110100010111010001101010000
0011011000000001001010010011000100110111001011101010110001011010011000101000001000001010001101000100000001110001111001010010100111000011000000001001000100000010001100110010000100010001100100001011011001100011000000110100001000000011000010011011001000100000
0011011010110001001010010011010100110001100011100111110001011100011100101000011000101010000101000001000000111001001001001011100110111010001000000000000100011010101101101011000001010000100100001011011111001011010100011100001001000010000010101110000110000000
