1101001010011110011000110011010000010000100010110011101001001100011000111010111000001010000111000011100000001101001000000000000000010110000100001101010000011010111000100010000001001000110100001010001001000001000110011110101000000000000100000111101010101001
0101001011001100011010111011010101010001001010110110101001010100011001011011000000000100100111100110101000010111101001010000000100000111010000101001100100010000011001110010000000011000110100000000001000000101000110010111010000000000000110010101101010101000
0101001010000000100101100001000001100111011100011010111001110010000101111111010110010010100010100111001001001101000101010100100110011101111001100010101100100000000101111001100100110000010010010001000001000100011100010010010000011100011011010101011010101000
1101000100011010111101100011001011011001001000111010011111110000001001111011110000000010110111100011010001001100001001000000100000000110110001101011001010010000010001110001000101110011110000010000100110110100000010111010011010011000001110011000001100111101
0001000101011010010000110011000110011101001000111010011101000000001001111011100010100010000110001011110001001000001010000001000100010100000000001001000010010011111000010111010001010001100100000100101110110000010010111000001011011000101110011000001110110010
0001100110000000111010001001001100110111001000011011100011101010000011111011000101000010001010010011001000000100010001101000011110100111100001100011001100100010000001110000000110110011000000110100000000010110001000110101011001011110110010011100001100101000
0001000000110010101000001011010100110111100110111011100110101110111110001000111000011100001010000001000100100000000000001011011010100000100101111111011100001010110100101110010110101011100111101110100000011010110000111001001101111110100010111010001101010000
0101001100010000110100100011001100010011011001111010000001110010001011111101100000000010110011000011001000001000010001000000001110100110000001101011000110000010000000110001000010110000100000110100000100000110000000010000000010011000110010011000001100100100
0011100001011000101101000010010100010000100011111111000011011100001000001000111110000000110001010000010000000010101000000100010100001000100001100110001001011010110000100000000001100001100100000000001010000000001010000000001000010000010010010010110101000100
0101000011000001011110000010001101010011001010101111001101011010000001011001000000100000100101011010001000000001011001010000100111101111000000000000000100100010000000110000000000000001000100110000011000000000100000110010010000000000000010010101111000101010
0001000101001000011110100010001101010001001110111010000111110000010001011011010000000110100101101111001000000100001011011000000100101111010000000010100101110001001001111000000110010011001100000000001000000100100110110010010000010000000010010000010000110001
0010010101111010000111000011011110011100100000111101000110111100101010000000101011100001110101010000010000000010101001001111001100101010100000110111001000010010000000100000000001110000100100001010111011001100001010011100001100100010010011111010110100000111
1011110110111011011101000011011000011000100111111111000000111100101000000000111111010000100101010000000000000010111010000111001000100000100000100011001000011011110000100000000001100000100010011010000010011010001010011100001000100000010111111110011100010111
1010110110111011011101100011011000001000100111111101000100111000101000000000111111010000100101000000000000000010111010001111001000100000100100100011001000011001010000100000000011100000100010011010110010011010001010011100001000100010010111111110011101010101
1100000100001100010101000011010011000100000001110000101110000100101100100100100110011111110101001101010001100011101100100100011000100001110000001111100010010000011100000000000111101010110010100110001101011001110010011000000110011010111111011011111100000110
1011010110100011001101100011001001001010101111111111000101111010000111001001010010100000110010000000001000000000111001001111000100001110110000110110001010111001100001110001100001110000000000110101110010011100011010010000010000110010100111111000010100100100
0011100100110011111000000001001100111000101011000011000001100010001100001000110101100000000000000000000100000000110011000011010010000010100101101111011010001110100011010010000001110100100011011010100010001000011000111000101001110110010000111010101100100001
0111101110000100111111101000001111000110101110001111001010111010010001011111010111111100101000110110001001100101010101110100010101001101110001100011101101100110100100110101101100100110010010110101000110110001001100000110011010010101110010010101110110101110
0010101101000000111111101010101100010110111010111001111011111111101001110111010111001000111010010111001001101011010101111101001100111111100001000111001110101010000101110001000100110010100100100100001001100111001100000010000010001001111010111100011010100100
0001001000010000111011010010100110110000100110111011011111011001111101011011110110111101100000011010100011110001010100101111100001010001000001000100000101011010100101001101011001000000100010001001000001110001111110100110001000010101001110110000111111110000
0111100111001100101010001000111101110101111010000101001010101101010011011011011101000100001001110110001111100111100101111000110111001111110001101110101101110110101001011010100110111110011100100001111100100001001100000111111001000101010000010101000000101001
1111110110100100101011010100001001100111111110001111001010111010010011101011000011011100101110110111101010100110111001011100010100101101010100000000101101100000000111011010000110100110001110110101110100001101001010100110010000100100111110000101010011101001
0000100001000001000110100101001110101110111000001101110010001010110001110101000011011010100001010111001100101110010011011011001011101100101101111011011100100110000011111101110010111100101001010000100110100111101000011100110000101110101011101000010000100010
1111111110100100101110011100011001100111111010101101001010111010010011000011010011011100101110110110101010111100110001011110000010100111010000100001101101100001000111111010000110100110010100110100010000111100001000100110010000100101111010000100010011101000
1011111110101000101110000010111001110100000011111111110011111001110101101100010101101010100001010000000001101001100101001011000010010011110001111010001101011000110101101001000101100010100010001010110101001001011010000101001000101011010110111110001111000000
0010011011000001001101000100110100100110010011001101010100010111000010000010011111001000100000010000101110001111110011001110001111111000101001100000011101101110000101000100111011110100001100001011011011010010011100000110100000001100100000100110010111001000
0001110110111000001100011011001100110000001010111010100001010000001110101000101011000111101101011100100001010001001011100100001110101111000000000001000110011011001101110000010111010011100100101110111101001110110010111001001010111011100010101111011000111000
1011100100011110000000101011000010011110011001110010100011100000001011011011100001000101011111000111010001001000101011000000011000100111001100101111011110010001011000010010000110111011110001110100100000010110001000111000011101101010111111011001101100110110
0101100000111110000000111011001110011101001000111010100001000000001011011001100001000111011110001011110001011000011011000000001000100110001000010101000010010011100001110100010011010011110010110100100110011110101010111001001111101010101011001001101100111101
1111100000011110010000111011001010010000001001110010010011000000001000011011100001000101011101100110010001010101101011110000000000000110000100101111011010010001011000010111010101011000110010111000000100000010001010111001101111000011100111011011101000111101
0111100100010111100000111101000110011101011001000010010001100000101110011011100001100111011111010011110110010000100010000000001100101110001001111101011010010011001111010010000011011100110000110110100100000110001000111001101111101110101001001011101100110111
0101000100011111001000111011000110111101101010110011011101001000111101011011110100001110001010001011110011111000000100001001100110010100000000011101000000010010111000011110010001000001110010010000101010010101110010111001000101110100001100011000101100100000
0000011011000001001110000100110100100000100111001101011100011111010000000000011110111000100000100000001010000011110100001110110111011000101000100010001001101110000110100001101001100100001100001011011001011000010110000110000000010100000010100110010011001001
0101011110010000110100000000100110110000001101011110000001010011000110001111001110110001110000011000001000000101010001001100010111001100100001000010000011100110000101110001101001110001001010101101011001010000100100000000001100010110111011010000110101101010
0100001011000100011111000100110101100000111110001101111100011101000001110111011110000010100000101111101011001110000100010100100100011101111000000000100101100010000000000101111100000110011100000001001000010000000100000110000000011100000000000101010011101011
0001011010000001001010000101100100010010000001101111110001010110010000101001001001001000000100110110001001100001011001111011100101001011000000010000101101101011001111001010001000010100001100001001011101100001011110010100001001001011000010100100000011011000
0110100111011010011000110010110110111100111011101101100011011100110011110101010001001010000100011110101011111110111011001010001111101110010000000000000001111010001011010110011111010010001100100100101010000111101010101010000001101110101000000000000000101001
0100100111000000011000010010111100110100011010101101000111110101100001010101010101101110010100101110101001000110111111111010010111001111000000010000100101100011001011010000001100010101001100100101011000010100101010100110000011011001111010010100001000111001
0100100111010000111000010110011100100100011100101101000011010100000001010000000111000000100100001000101010000110011001000100010110001101000000000000000101110010001011010000010001010010001100000000001000010110101010100000000000010100010000000001010000111000
0011000000011001011000111111000110110001111011100010010101001000101000011000111001000101011101000010100110010001100011101011001111000110001000101101010010011011101001010010000001011100100000111110000000000110000000111000101011000111110000101010101100110000
1101000100111110000011101011001010001000001001100000110000000000011101010000100110110001011111001000010101101010001000100000101000000000100101011001010010010100011000010001000001011000110011010010100101001101110000011001110110111011000101001011011100101111
1111101111001100010010110011001001010111001000100010111010100000000001111111100001001011010111100111111001011011101010010000100000010111010101101001101110010001011000111011000100001010110000010000000001010100001110110100011101001000000110011101101010111110
1100000100111111100111101000001011001000001101010000111100000000000101010011100110110011011110100011111100101110001000100000001000100100110100010001010010110100011010010001100001011100111011010000100100011101010010011011110110110010011101011001111100101111
1111111100100111110001100101001010011110010000000010010001100010101000001000101101001001010011000100010101001011100010011001011000100010001101101111011110000111111110100011100010111111110011011110000011011010001000111000101101001010111001001011101100010110
1111110101100110010101010011000011010110001000111010101010001000100011101000100101011011111111100101011000011010001010010000001000100011110100101101101110000001110000110110010110001010110011111100110001011010001010010001011110101010101111011001111000010110
0111101001011110000001110111001110010110010101100110001010100000101000011000101111000001110001000010110111010011100100000011101100000000001000111111011010010011111000010010000101001110110100001010001010010010001000111000101100000110010001001010101110100110
1001100101000000000001010010011001010110000100110110000010110010000001000000010101000000110101010100011000010010001010010000000000000010010101111110000101100001111010110010000000001111100101010000000000000000100000000000011100000000000111010000111001010110
0110000111011101011111110100111101100000101111011101111000011101000001110111000011100010100111101011001001011111111101000100100100011100011000000000101001110111001011110001100101010011011100000001001001000100001110000110010000001000000010000101010011101001
0110111111011101001111110110111101011001101111111101111000011101000000110111011011100010100111101011101001011111101101000100100100011100011000000000100001111011001110000001001001000001011100000001011000000000001110001110000000001000001000000100010111101001
0010011011000001001000010110110100010001100011101101111001011101001000101110011010101010100110000011100011011101111101001111100100011011001000010100001101001010101111100001001001010000001100001011001011000000000110000110001000000000000000100110000111000001
0011011011110001001000010111010100010001000011101011110001010110101000101100011000100011100111000001000000011001111001000011100100011010001000100100000100001010101111101011001001010100100100001011011011001010000110111100001000000010010000100110000011010001
0001011010110011001000010011000100110011010001111010110001010010001000101000101000000010100111000001000001011001111001000011101110100010001000001111000100001010110101101000000111010010100010001010000011001010010100011000001000001010000011111111001110000000
1011000100001000000000110011001001110111001000110010111011110000001001111011100000000011000111101111000001011101101100010010100000010111010000111111101110011000111000110011000100011010110100010000001001000100001010110010011100001000010111111101001010100000
1100010101110110111100001010111010000111001010111101000110110111110010000000111000001100101001000000001000100110010011001000011001101111100101100010001101110001000001101100111011100010011100100111111110111011100000101100010000111011100110010000010101011000
0100010111111110111100001010111101001000001010111000000111110101010011000001011010001100101001000000001000100100010101001110011101101110010001100010001011111011100101111100100011100011001100100101111100111001000000101010010000110011100010010100110101111001
0001010111010000011000011010111100111110100010111011001111010111001010001011011000001100001001001010000000110110010100100011001111101110000001001100000011101011100101101110011011000001001100101101011100110011100100101011001001010001101010110110100111110000
0001011100111100110010011011010110110100100000111011000111001100111110001000101000000101001100001000100010010001011010101001101111101001000000000101000100011011101100000110010011000001110100101010001111111011100010111101001101010111000000111010101100010000
0001010100111110110010011011010110111100100000110011100110001100111110001000101000010100001000001000100111011001000110101001111110101000000000000101000000011011101000000110010011001001110010001010100011111011100010111101101101110111001000101010101100010011
0101000101111010011000011010110110111000100110111101001110001101111010000000111010001100001100001000100001110011001110101011001110111000000000001101000000011011111000001110010111000011110100101110101001111011100010101101001001110001101110011010111101010010
1110010101101100011111011010111011000010110101111101000110111101111010010100111110101110101101000100000000110010101010011110001001100001110100101110101100010001011110100000000010101000111100100110111010011010000010000101000000110011110110011010011000010110
0000011111111010011110111010110100101100100010111101000011011101011000000010111011101100110010001000110011111000001111101111100111011010000000000000000001011011100101001100111001010001001100101111011110111001100110101111001001111101000000110110000111011101
0000011101000001001000110000110111111101100010011011001101001101110110001011011010101010000010101011111010110000010100101011100111011000010000000100100001101010100110000111011001000101001100001001011110000001100110100010001001010100001000100000100111010001
0001111000110001001000010101000100111110110000000111010001000110011110101000011001101110001100001000100010110001010010101011001111101010001000001100000000001011101110001111010001010101100100001111011111101011110000111100001101100011100000101010100100010000
0001011100110001001000010011000100111100100110101111110001010110011110001000011001101000001001001000100010110001010010101011001101001010000000001101000000001011100100111111010001010001100100001111011111101011100000111100001001000111000010101010100100110000
0001110001110001001000010111010100111110010110101111100001000110111110101000111001101110001101001000100000110011011010101011001111101010001000011101000100001011101110011111010001010101100100001110011111101011100000111100001000100011000010101010000100110000
1101100010111011001010100101001001101000100011000101000000001000011000001010110001111000000110110000000110000001001011001010110010000010011100001011111000011101010011010011100001111101100011010010100000001100101010111100111001100110011100101110001000110001
1001100010111011101000110101001001101000101010010111110001111010110000001110110001101100000011110000001110011100000011001011110010010110011101101011111000101101110011110011100001011100101001010010100000001100101000111100110001100110010100101110001000111001
1011100110000011101000111011000001111010101010100111010001110010010001011111010001101010001011100011001000110100000011111011100010010111010101101001101101001001111001110111010000011100100101011000100110000001001000010111011001100010000110110100001000110000
