0000010001100000100101000000110110000100110100001001101010011111100010000100001110001100110000010000010000000011010100001111011101111001100000110110001101101110100100101000101110100010011100001011011001001011001100000100001100111001100010100010110101000110
1111101110000000101100101101001001100111011011001010110111100010000101111011000101010011000011110111001101001100110001010000110010000111111101101011111110100100000011110011100100110110110011010000100100000100011000010011110011001100010011011000001000101000
1001001100011010010100100011001110011001001000111010011111110000001001111011100000000011100111000011000001001100001001000000101000000110110000101011001010010001011001110001000101110011100000010100100110010100000010111010011010011000001110011001001110110101
1100001000011111100101100000100011001001001101011000011100100011000101110011100110110001110010110011011111001110110100100100110000010100110101110010111011110100000010010001101001100000011011010000000010100100110100001110110100110100011101000001111011101111
0111101010001101000000111111000101110001011001100010011001010000000101111111000001100011001111101011101001111100101010110000100110010111011000011001100010100001001011110111000000010101110000010000000100000100010010110111010010000000001101001101001010111011
1001010000101011001000100111011010111011110011100111110000001101101100101100111000011010000111010101000101001000001000011011001010110000001100011110010000011000111000001010000010001100100011011110000000001010110000111000101001111010001100111010001001000000
0000011101111011110101110011010110001101000100111000111100010101101100100100101010110011100010001001100010111011000100001111011100011000100001000100000010010111100100000101111001000001101100001110001111011100110110011000000010111110001001111010010111010011
0100110001100111010001010100110011001111110100000001001000001111000010000010001011110110100000011100101110010110010100010100001001101000011101010000110011100100000110000110110010001100011101100011111000001011110000101110110010100100101001000010010101001010
1100110001100001010000010100110001100111110000000101001010001111000010000010001011110100001000111100101110010110010100110100001001101001011100010000110111100100000110000110111010001100011101100011111100001011111100100010110000100101101001000000000011001010
1110001000000100100010110100110011100010011011000000111110001111000101110111010110010101010110110110101111011111101100010100100010010101011100000000111111100100011110000000101100001110011011010001000001100100011100000010110100001000011100000001110011101010
0011010100111010100111000011001100011001100100111111100111111000111000101000111010001010110101010001010000100001111000001111110100101010100000110111001000011010100000101000000011110000100100101110001111011011001010011100001100100010010011111010111100000111
1011010111111011001101000011011000011001100111111101110100111000101000100000111111011010110101010000000001100010111010001111001001100000100100110011001000011010010000101000000011100000100110011010100110011010000010011000001000101010110111111110011100010100
1010010111111011001101100010111000001001100111111101000000110101001000000100110111101000111001010000011000010010111010001111001001100000100101110010001011011001000000101000000011110000001100001010111010011100000010001000010000101010100111111110011101011100
0011110110111010111100000011001100111001100011111011110111101000001100001100111100000000001100000000000011100000101001000111010110001010100001100111001010011111101001010000100011110000100010001110100111101100011010011000101001111010010000111110001100000001
0110011111011010010100111011011100011000001000111000000100010100001010000010001000000101111100000000111000110110011001101110001111101110100000000000001011110010000001101101010011010001001100100111011110110110100010111011001011000011100011010111000101101100
0110010111010100001000001011011100111100001011101100001101011110001000000010001100000110001010011000010010110111110000100000001110101110000000001011000010000010000101000111010011100001011100100010011101010010000000111111001111010101100010001111100100101000
1001100000001010010001111011011001010101010000100010010001000000001101111110110001000011001111101011110101011000001010000011100000000010010100011101110010011001111000000011010101001111110111011000000000000000010000111011111111001000000100101010101010110001
1011101100001010010001111011001011011101010000100010010010000000101100111100100001010011001111101011110011011000001010000011000000010010011100001101110010011001111010000011000101001110100011011010000000001000010100111001111111001010001101101011101010010011
0011101101011110011010111011010000011101000111110010001011010100011100011010111001000011010111101011110001011000101110000001000100010010010000101101000010011001111010100011000101001000110100101110001000000001000110111011001101001000101100101110101010100001
0111100010000101111111100000101101000111111110001010001010111010010011011011010110011101101000110110001001100100010101110100100101001111110001100011101101100110100001110100111100100110010010010101000110010101001100000110010010011001010010010101111100101110
0001001100010000111010110010101110110000100110111111011001000101111101011011011111111000001000011010100011110101010110101111000101011101001001010101000001011010100000010101011001000000110010001101001101110001111110000010001000010101001000100000011110100100
1110011011000001000111101100100001000011101101001101011100011011110001010011010110101100100101100110011000110011111100111011100001010111111100100010101001101100101110111001101000100101001101010001000000100101000110000111010000010001001011100101010010110111
0010111000100011100101110101001010001110011100000100110000110010110000100000101011011011100010011101100110101001000000111111001000111100001101010001011100100110001110011001101010110100101011110110100101111111011000111000100000110110111001101010010000100110
1110110111100101111010000100001001100111011010000101001010111010010011100011000001100010100011110101001010100110100001011000010111101111110001100010101111100100001111011010100110111110001101100101111100011111001000000010110001100100110100010101000001101000
1001101000011010001010000011100110110100100110111010110011001001111100001000111101111101000000011010100111100001010110101111110011010001100001000100010000011010110001001101011001000000100010011011000101110001111100011100001101010111001110110010101111000000
0110110111000100111010000100011101100111011010001101001010111110010011100011000011001010101110110111001010100110110011011000010111101111010001100011101101100000001111011010000110110110001100100100111100000111001000110010110000100100110000010101000000101001
1000010111000001101010010010111001000010100010100111001001111111110011000111010000101100110101101100011000100001001111111011111111111011010101111110100101101000101111101010101110100101001101001001111001110011000100100110010001110001011110110100100011000000
1001111000111010100010000001000000111100110110011011110011001001111100001000101101011101000000010000100111100001010010101011110011010000000101100100011000011101110100001100111001100000100011011011000111111001111100011100101101001111011101110010101111000000
0010100000110011010110100101001110101110111000001000110000011010110001111101100011011011100000010101001110111000110011011101001011100000101100010001011100100111000011111101110000110100100011010000110111111111111000011100110000101110101001101000011100000010
1010011010000001001100000100100001100011110101000101000100111111010110000110011110111100100101100100001100100001101001111111100011011001111100110010111101101100001111101001101100111100001011001011011011100111001100000110110000010001010111100110010011010000
0000001011011011101110000010110100100000100111111101110100011101011000110110111110001100100000011010100001101111011001101110110111001000100001010000000001011010000001101101111001000001001100000011001011100011110110001110000000010101000010110110010111001001
0001100010100000111000001101001100100110011011000010100011100010001110111000110001000110001000010100000110100001110011010010011011100011001101101011011110001010010111010010000110111110100011110010010011001110011000110001110011010111110000101110001000001000
0001011010100000001100000111001100110010011111101111100111010010001110101100011010001110101001000100000000110001110011011111001111101011101001111011001110001010100101111000000110110110100100101111011011011110010000010100001010000011100010111110010100011000
1001100010100000101000011101000000110110011011100110100011100010001110101010111001000100001000011100100110000101100011010010011010100111001101001011010110001010010101010110010110111010100011010010010111001110011000110001101011000011110100101110001000101000
1001100010100000111000001101001000100010011010000010100111100010001101111000100001000110001001010100001101000101000011110010011010100111001101101011011110001100010111010010000110111110100001110010110011011110111000110001111011111111110100101110001000101000
0011100010000000011000111011001101110010011011111111000011010100101101011111010001000100001101110010000001010101101111100011001111010111011000001011101110011001011001110011001100011010100100100000001000100100011110110011001011000001100110110100001010110000
0001110111111010001000011011001100111100001110111000100001010100001110001000111011000100101100011000100011010001001011000111001110101000000000000001000010011011001101010110010111010011100100101110111000001110111010111001001010101011100010101110010100101001
1011110110100000011000011010001001100010000011101010000011010010000011001110000001100101011101100100001000010000101011010000000011000011010100101010111111101001011011100010000110110110000101011101110000001100000010110001010011100011110110010101000001011001
1001000000111110000110101011001110111000001011111010100011000000001110011000100001000111011110010001010001001000011011000000001010100010100000111011000110010011010001110000000111110011100010111110100100011110111010111001001111101010100110011011101100101000
1011100110001000011000011011001011110000001001111010000101010000000011011000000001100111011101100110011001010000101011110000100011000011010100101010101111011001011001110010000100010010100100111001011000000100000010110001011111000011000110110001101000011001
0011000000011110000010111011001110111000001011110010110111000000001100011000100000000101011101100010010001011001101001100001101011000010000000101001011010010011011001010111010001011010110010011000000001000000010010111001001111001011000010011011101100111101
1011110100101100000010011111001011010011011001110010000001010000010010001010000001100111011111100101010000010101101011110000000000100111010100101111111110100001011111110010000110011110110001110110110000001101000010110001011101100010110110001011100000101101
0011000100011111000010111001001011011000001001000010000001000000000101001011000001100101011110100011111110010100101011100000000110001110010000100101111010110101001011110001100001010100110011010000100110100101001010111001111111100110001101101001101100110101
0011100000000101000011111101001110011110011001000010000001001010011011011001100001100011011111000111110010011000111011110001001000100110001000111111001100000011101011110011000010011100110010110100100100000111001000111001101101100010111001001001101100110110
0111000000001101000011111111001111010011011001000010000001001010011011011011100001100101011111100111010000011000101011110000001100100111001000111111111110000011101110110011000010011100110001110100100000000111000000110001101101100010101001001011101000110111
0011100100011111010010111001001111011000001001011010010001001000010001011011000001100011011111100011011010010100101011100000000100001110010000100101100010110101001011110011100001010100110011010000100100000101001010111001111101100010101001001001101100110111
0111111100011111000010111011001011011000001001010010000001001000010011011011000001100011011111101011010000010100101011100000000100000110010000011101100010110001001001110011000001010000110000110000010100000101001010111001011101000010101010000001101100110101
1111000100111100000011011011001011010001101001110010001011001000011011011010100001100111011111101011110001010001101010100000100000000111010100001101100000010000111100110010000101011010110000111010110000001001000010110001001101100010001111011011101000110111
0111100100000101010011111011001111010001101001110010001001001000011001011011000001100011011111101011010000010000101010110000000000000111010000001101100010000011111110010011000001011100110010110000000100000101001010110001011101000010101011001001101000110111
0000011101100001011000010001111100110000100010011111010001011111110000101000011010101000101100101000101000110001011011101111110111001011000000000100100001101110100111000101111001000100001100001011011111111001100110100000001001010011000010100010100011010001
0000011101100001011000010000110101110100100010011011010001001101110100101100011001101000000100101000100010110001010010101011100111001000000000000100100001101010100111000111011001000101001100001011011111101001100110100000001001010111000000100010100001000001
0001011010000000001010010011000100110000001000101110100001011110011100101000001001001000000101010010000001110001011010001001100101001011000000000000000100001011000101110000001100010010100100001011011101100001010100010100001000000011000010100110000000111000
0110000111000000011000100010111101110110011110000101001111100100110111010101010100001010000100101110101001100110101110011110010111111100110000010010101001100010001001010000001110111110001100100101001010010001011100100110000001011001101000010100100100111001
0000011010010001101100000100100100100011100010001101111001111111001100101110011000001010000010011111000001001001010101000111111110111011101001000100000111101110100101000100111100110000001000001011001001000010111100110010001001010100010010110110000011000000
0011100000011000011000010011000111110101111011111010000011001000001011111001110001000110011100000011100011010000111011001001100111100111011000001101000110011011101001010110010111010010110000011000110010000000001010110001001011000110011000101000101100110100
1111001110000100110010110011001001010111001000110010111011110000000001111111000001000011010111100111111001011111001110010000100000000111010101101001101110000001011000111010000100011110110010010100000001010100000110110110011101001000000111010101101010111110
1111101100001100110010110011001001010111001000110010111011101000001001111111100001000011010111100111110001011101001011010000100010000111010001001001100110010001011000111010000100001010110010010000000001000000001110110110011100001000001110011101101010111010
1101111001100111011000101001000010011110110010000010110001101010001000001000101001000101011001010100010101001001001011110000001000100010000101101111011010000111110111100010000000111101110101111010000101101111101000111001111001101011101110011010100100010100
1011100000100000011000011011000011010110101011111010100011000000000011111000110001000010011111001101111000011000111011011000100000100011010100001101100110011001110001110110010110000010110100011100110001001000101010110001011001101010001110111000101000010100
0111100000011100110001011011001110010101111101100010001010111000101011011000100001011101111101000010110011110010101111000000100100000111001001101101001000010011111001011010000101001110110000010100100010000000001000011001101110001011011000001011101100110110
1100000100111111100111101001001011001000001100000000001000000000000011010001100110110011111010100011111100101110000000000100000000100100110100010001010010010100010000010001100011111000110011110000100110001101010000011011110110110010100101001001111000101111
1111100101100110010001010011011011010110001100111010101010000000101011110000100111011011111111000101110000111010001110010000001000100001010100001101101100000001011000110110010110001010110111110100110001111010101010010101011110101010101110011001111000110110
1100000100111111000111101000001011001100001100000000011100000000000011010001100110110001111010110011111100101110000000100100000000000100110100010001111010110100010000010001110011111100111011010000100110101101010010001111110110110100111101001001111000101111
1111010101100000000001010011010011010110000100110110101110010101101011110000010111110010111111100101110000010010001110010011000001100001010100011101100110010001111100111110010110001010110100111100111000011000100010010000011100101010101111011001111000000110
0110101111011101001111110110111101001001101111111101111000011101000001010111011011100010100101100010001001011111111100000100100100011100011000000000100001110010001010101001101101000011011100000001001001000000000110001110000000001000000000000101010011101101
0100001111000101001111100100111101100001101111011101111000011101000001010111010011100010100101100010001001010111111111000100100100011101011000000000101001100110000011111001100101110011011100000001001000000100001110000110010000001000000010000101010011101001
0110001011000101001111100000110101110001101111111101111000011101000001110111011011100010100101100011001001011111011111000100100100011101011000000000101001101010000111111001001101000101011100000001001001000000001110000111000000001000000010000100010011101001
1101000111000001101111100101001001100011111110000101011100100010110111110101010110111010100011110111001000101010001100011010011000110101110101111010111100101000011010110011001110101101100011010101100000000111110100010100010000111010100111011100011000100010
1100001011000101100111000100101001000110011100001100011100110011010001010011000110110001100000110110001000100111010100110100110101011101111101110010101101100100000110110001101100110101011011010001000101100101010100000110010010010101011111010101010011101010
0011011011010001001000010011000100010001000011101011110001010100101000101110011000000010100111000001000000011001111001001011101100111010000000000100000100011011101101101011001001010000100100001011001011001010000110111100001001000010000010100110000010010000
0001010000000100111100000100100110100100111000001010110001011011100101111001010000000010000000011010101011000101010101100001110111001111101001000100100111101110100101110100111100110101011000010101010001000100100100100000010011011111000000100000100100100000
0011011000000000011010000101000111110110111011001111111101001010100100101011011000010000001000101110100010000101110101011011001111111111001000000101101110101110100111010100111100110110000010011001010101110100001100110010101011011101011000100010000010110000
0001111001000101110001000101011110010011011100001010110000100110000000101111001011000011010000001110110010000111010110010101011101111101001001000110100111100010000100000010001110110101010100001001011001010010101100110010001100010101010001000011100010101100
0101111000000100100101000100100110000110011100001010100001110011000001111111000001000001110000011110011001000101010010010100111101101111101001010110000111100110000101110000111100110100011100010101011001010110100100000010010100010100010011010001110011101100
0011011010110001001000000011000100010011000001111010110001010010001000101000101000000010000111000001000001011001111000000011101100100010000000011001000100001010100100100010000111010010100100001010001011001010000100011000001000001010000011111110001110000000
1101011000100100100101000100000110000110011100001010101011110011000001001111000101000001110000010100011001001101010010010000111001100111101101111110011111100111000100110000101110110110011001010001010001011110100100010010010100011110010011010001110011111110
1001110001100100111000010100110011110110110010100011110010101111100001111000010001010110001001011100001001010011010111011001111011100011001101001110110111001000110101100110010100001101010101011001110001001010101000100000010011101011001110110000101001000000
0101101000000100110101000111000110010110011100111010111101110010000001111111000111000111110000011110011001000011010010010100011101100101101001000100000110000011110100110100010110000010110100011001011001010010101000010000011110001011011011010001111010110110
0101001001000100110101010011010110010110011100111000111010110010101011111100101111010111111000011110110011010011010110010100001101100101000001000101000110000011100100010100010110000011110100000001001001010010101000010000001110001101111011010011111000110110
1011001100000000000000110011001001110111001000110010111011110000000101111111000000000010000101100110001001011101101110010000100010000111010100101011101110010000011010111011000100011010110100010000000011000100000010010010011101001000010110011000001010110000
0100111101011110100101100000111111001100010100001000111010110101000001000011001111010101110110110110111001001110011100010100011100111100110000000010101111110101001010100000101110100011011110100101001000010010101110001010010100011100111011000101110011001111
0001010111010010011000011010111100111110100010111011000111010111000010001011011000001100101001001000001000110100010100100011001111101110000001001100000011101011100001101110011011000001001100101101111100110011100100101011001001110001101010110110100111110000
0001000101111100011010011011011110010000100000111111000111001100111010001000101000000100001101001000110000010011001100101001011101100011000000001101000100010011110100001110010111000011110100101110011010111011100010101101001101010011100010011010101100010010
0110010101111010011101000010111100001001000101111101101110010101111010100000111110011110100101000001000001101011101100001110001101111000100000110110001001011010101000100000001111100010011100101110101001001011000110001100000000111001111010011110010101000110
0000111011000001101001000100110101100110111110001101001000100111110111010011011011100000100000111110101010100101010110111111110101011101011001010000100111101111100110000101111100000101001100000001001111100001111100100010110000000101001000110100000011110000
0000010111111010011101000010110100001001000111111101101110010101101010000000111110011100110100000000000001100010101100000111001101111000100000100010000011111110001000100000101011100000001100101111111100101011000110001000000000111001101010010110010111000101
0100010111111010011110011010111100111000100110111101001110111101111010000100111010001100111101001000000000010010001111101110001111101000000000000000000001011001111000101000001111000011001100101010111010011011100010001111001000110001101110110110010001010001
1111101010000100001000111111000001110010111010100111000001001010010001011011000001000100001111100110101011111101101011111000100011000111011100101001111100100001011011110111011100011110000001110000000101110101001100110110110001000001000101000101001010111001
0000011000100001111100000100110111100110110010001001000100111111110110000100011100100100000000000100101110000001010101111101010111001011101101100100111101101111100111000100111010100101001101101111011111111001100100000100110001010111110000100010100111010000
0000011001100001111100000100110110100110110010001001000101111111010010000000011000100100000000000100101110000001010001111101010111101011101001000100111101101111100101000100111010100101001101101111011111111010100100000100100001010111110000100010100111010000
0000011111011010011100111010111100101000100010111101000011011101011010000010111011001100110100001000100001110100001111101111001111011010100000000000000001011011101001101100011011000011001100101011011000010000100110001111000000110001101010110110010111011101
0000111011111010011000111000110100101100100010110001010001011101011000000000111001101000000000001000110011110000000111101111001111011010000000000000000001111111100101001110111011000001001100101111011110101000110110101001101001101101000000100110000111011001
0000011000100001101100000100110111100110110010001101000101111111100110000000011000101100000000000100101110000001010001111011010111101011101101100110111101101110100101100100111010100101001101101011011011111010100100000100111011010111110000110010100011000000
0001011101000001101000110000110111111101100010000111001101001101100110001011011010100010000010101011111010111000010100101111100101011000010001010100100001101010100010000111011001000100001100001001011110110000110110100010101111010100011000100000100111010001
0000011101000001101000110000110111111001100010001011001101010111100111001011011010100010000010101011111010110000010100101111000111011010010000000100100001101010100111000111011001000100001100001001011110110000100110100010001001010100001010100000100111000001
0001111000110011001000010101010100111100010000001111010001000110001110001000011001101010000000001000100010110001010010101011000111001010001000000100000001101011101110001111011001010101000100001111011111101000110100111000101101101111000000100010100101011001
0001011100110001001000010011000100111100000110101110010001010110001100001000011001100110000001001000100010110001010010100011100111001010000000000100000000001011100100111111010001010001100100101111011111101010100000111000001001000111000010100010100100110000
0001111000110001001000010101000100111110010100101110010001000110001110101000011001100110001000001000100010110001010010100011001111101010001000001100000000001011101110001111010001010101100100001111011111101010111000111000001001100111100000101010000100010000
1001100000111011100000101101001000010000001011000000110000000000101000011000100001110100001110110000000100000001000011100001110010010110011100001011111000011101010011010011000001111000100011010010100000101100101010111001101001100111011100101010001000110001
1011010101111010000000010011011000011100010100110000000010100101101110001000101110000100100111001100100101010010001010000001001011100000000100001000010100010001111010000010011110001011100101101111111000001010000010111000101000101010100100111010000001000001
1001100100111010000100111011010000011101000001110010100011110100101010111000101001000100001111001101000001010000101011100101001000100010110000001011000000010001111001100000000111011001100100101010101010011010101010111001001001101010100110011010001100010000
1001100000111010000100111011010000011101000001110010100011010100101010011000101001000100001111001001000001010000001011100101001000100010100000000001000000010001111001000100000011011001100100101010101010001010101010111001001001101010100110011010001100010000
0011010101111010000100010011011100011001010001111010000110010100001010100000101010000000101101001000100011010010101000000100001101101000100000000001000000010011001110100000010111000010100100101110111000101010000010111000001001101011100000001010010100010001
0010000100111010000000001010001100011000000001111000000110010000001010100000101000100000000100001000000000010000101000100100001100101000000000001001000000010010010000000101010001000000100000100110101000111010100010001001001000110001100010001010001100000001
0000110100111010000000001000001100011000000001101000000000000000001010000000101000100100000110001000100010010000111000100000001100101000000000000000010000010110001010000100110011000100101000100110111000111010100010001001001000111101100000001010000101000001
0000111000111011000000010110000101011001000001100000000010010000001000000000001001100000000101100000100000010001001010000000010101001000011000000000101000010111001110000011000001000010100000100111011011101000100010001000001000101001100000001010000000010001
