1101101010000100000010000000000000110000001000000010001001000000000101011011000001000001010000001011001100100100000111000000000010010110000100001001010000100000010001010010001000011000010011010000000100100100011100110110110111000000001101000101001010101000
0000011111100100101111000000111100010110010110101101100110111111101010100100011110001100110000000000010001100011010100000111011101111001000000000110001101101010100100100000101110100000001100101111011001101011100100000100001100011101100010110111110111000100
1001100100101010111000010011001010110110010000110010100011100010111010111000100001001111010001011100000111111000000011001011011010100011000101001111010100011001111001011010000110011010100001111110100100011011100000111000101011101010110100111010001100010000
1011100100001010100000101011001011111111111000110010000011101000001111011011100000010000001011010111000101101000100001000000001010100110010101111011011110001000011001010010000110111010100011110100100100100111011000111001111111101000111101111000001100101010
1111100101011110010000111011001011011101111000100010001011011000001001011011000001100001111111101011110011011110101111100000000100000110010000001101100010010001011010110011000101011110110100110100000000010000000010111010111010001000101100001001101100110111
1011001110001000001111101011011001010001100011110111111101111100011000111110111000001000101111110111000001101001101101011011100000010011110100101111111100011000111101101011000100101010110101001110000001100001000110010111001000001000010110110110011010100000
1100010010100010101010111101000000101110011010000100110011100010010100101011100001111011001010011101101110111100010001110110011010101110001101010001110001100100000011011110110010011101001011110110100100011111111000111111110001111110100101001101000101101000
1011100010000011011010111101000001111011111011000011110001001010010001011001110001101000001111110111000100111000101011011011000010100111011100101011111100001001011011110011000100111101100001010100100100100101011000110101111011101010110100101100001000100000
1001101101111010001000010111010011110010110011100111110011001101101000101000111001000010000101101100000001011001001011011011100010110011011100001110110110011001111011100010001100001111110101001111001101011011001100111000101001101011001100101010101001010000
1011100010001000001010111011000001110001101011110111000001001000011111011011110001001110001111100111000001110100101011011010100010000111010100111011111100011001011001010011000110111010100010010100100100000101011010110101011001000010010110011100001000111001
0111100110011011011010111011001100111001001001110110110001010000011001111011100001101010101111000011000000111100101011001010101010100110000000101001001000010001011001111011000001011001100100010000100110010101000010011101001000101010000110011101001100111001
1111100010000100001010111111000001110111111011000111101011001010000101111111110001001110001011111111000101011101100011110000100010000111011100101111111100001001111011010010010100011110110001111000100001000000001000110111111001000000010100001100001000111000
1011100000000100001010111111000001110110111011100111111011101010000101111111110001001010000011110111000101011001101011110001100010000111011100101111111100001001111011010010000100011110110011011000100001000000011000110101111001001010010100101100001000110000
1011100110001010011000111011001011110101001000110010110011101000001001111001110001000011001111101111000001011000101011010000110010000111010100001011110110011001011011011010000100011010100001010100100010000100001010110001111001101010000111111001001000100001
1011100110001010011000111011001001110101101010110010110011101000001001111011110001000011001111101111000101011000101011010000110010000111010100101011110110011001011001010010000100011010100011010100100010000100001010110001111001001010000101011101001000100101
1011100100001010100010111011001001110001100000110011000010100000111111011000110001011111001111111111110100111000001010111011001010100001010100011101110100011001111000001011000110001010100011111110100000000011010010111001111101100010100101111010101000000010
1011100100111010100010111011001010110101000000110010000010100000111111011000100101011111001111011011010100111000101010101011000010000001010100011101011000011001111000011010000111011010100011111110100100001101011010111001111101100010110101111010001100000011
1011110000111011000000110011010001111101100010100011010000001100111100001000111001111010001111101001100110111000101010101011100010000000010100011101110000011001111010001111010001001101100011001010100000011001110010111001101101100010001101101010001001010001
0110100110000110111110101100001100101001001101011000001010011000010001010011100111111110101010010011001000101110110111100100010110000100110000100011001000100101000010110001100001110000011010110100100100010100001010011111010010100100110111001101011110101011
1011100100111010000010110011011001111001100000110001000000000101111110000000111011111011000111111001110110111010101010101011000010000000010100011101110000011001111000001011000111001010100011101010100000001001110010111001101101100010100101101010001001000011
1010110100111010000010111011001011101101000000110000000000000001111111000000100101011001001111111001110111111010101010101011100010000000010100011000110000010101011000001011100011001100101011110010100000001101011010101001110101100010110101101010001101000011
0010011111010001101111100011011100010000001010111110111111110100000000101111011000001010110011100011000001001101110101001110100100011111100001110010001001111010000101100001101101110010001100001001001001010000000100010110001000011000010010010111010111101100
0011111100111000011011000011001110010011100011111011100011101000111000101100110001000010000111000001010001011001101010101011001000110011000000101111001100011011111100111011000111110010100000011010010011011010011010111000001101001010010010111010001100000100
1110101010000100101100101100001001100010111011001111011111111010010001111111010101001000101010110111001001100100110101110100110010001111111100110011101101100100000111110001100100110110011001010001000100000101011100000111010000000100010011000101011010101001
0011010111011000001110011011010100010000000011111111110001010101001010001100111001001100111111000000010001010001101001000011001100111010000000101010001100011011111101100010000011000000100100001110001010101011001110011101001000101011000010111110000111010100
0011000111011010001111001011011100010000000011111010100011011100001010001110111001001100111111000001010001010000101011000010001100101010000000101011001100011011011001100000000111110010100100101110001010100011000010011101001000001010100010110110010111011100
1000010001111011001000011011010000111100100011100101000100000100101110000000111010111100001000001000100110110010000000101011000011100000001000011101010000011010111000000111010011001001100011101010111110101001110000111001101001110111100101101010000101010001
0100100010000001001110101100100100100000101011011111001001011010010111011011010101101100001000100010001000100100110101111110110111001111101000100011101101101110000111110000100000110001001010010001000110100101111100010111010011010101010010000100000010101000
0001000101111010111000010011010110111001100010110111000111011100111010001000111001000100001101001000100000010000001011001011001011100010000000001101000000011011111001101010010011001001100100101110111010011010100010111000001011101011101110111010101100010001
1111101010000100101010111100001001010110011010000010011111100010010101011011000001001001001011110111011101100101100000110000100000000111011101101011111101100000011010110011000100111110010011010000000100000100010100110111110101000000010100010101101010101000
1111001111000100011110100010111001010011101011111111111111111100010001111111010000001010110111100111001001001101101101010000100100011111110000100011101101110001001101110000000100100010011100000000001001000000000110100111010000011000010110010101111010111100
0011000110011010001101101011001100010000001011111010000111110000001001011011100100101010101111000011000000000000101000101010000100000110100000101011001010011011011000110001000001110000100100110100100000000100000010011001001010110010100110011110011100101101
0011000110011010001100101011001100111001001011111010000101010000001001011010100110000010101111000011000000001000101000101110000100000110100000101011001010011010011000110001000001110000100100110110101010000000000010011001001010110010100110011111011100101001
1110101110011110000000110011001001000100000001110101111010100000001100110111110110010010010111111111010101011001101100010100100000010001010100011111110000010000111010001011000101011010110011011000000011000101011110111110111101011000010101010111001010100011
1110001111000100001111100110111001000011111001111101111011111010010001110111000001001010110111100111001001001110111111010000100000000111110100100011101101100000000011110001100100110110011101010000001001000101001100000111010000001000010110010101111010111100
1011100110011010000010101011001001111110111000110111110011101000011101111001110001001010001111110111000101101001101011111011011010100110010101101111111000010001111001110010000100111010100011010000100111001111001010111101011001001010110110011100001100110000
0000110001111011000001110100110100001101110100000000001000001101101000000100101011111000100010011001110110110010010110100101001101011000001001000000010001010111100000000111111001001101101110101111101010101000100100101100100110100100101000101010110111000011
0001110000010001001010111011010100111101101010110111000001001100011110011110011001001110001110011001110000110000001010001011011110101100000000011101000000011011111100011110010011011001100110101110111010010011110010111101001101111010100000101110101100100001
0100001011001101000001101100001001000000001101000000111100000100001101110111001110001010000110111111111111001100000100100100110100001101011000010001110101010100011010010011100100011110011100000000001000000100110110110111100100010100000101000101101010101001
0001001011010000101001010010110100010100000111110110110000000111001001110000110000000010110001001001010001111011010000000010110001100011000001011000000110001010010000000110011111001011100100011111001101001010101100100000011110001010000010011101001111001110
1011001100000000001000110011001001110010001001111110100111001010000001011111000000001100000101100110001001111101101001110010100001010111010100101010101100000000011010110010001100110010100000110001000001100100000110110010011011001001010111110000001010100000
0111001110001000011000110011001101110000101001110111110011000000001001111111100000001000000101110110000001111001101001100000100011000111010000101011101110010000011101110011001101011010100000010000000111100100001110110010001011001001010110011100001010100001
0011011100011100000110010011001111010000001100110010110111110000001100101010001110000011111101100100010001011101101001110100101111101101100001110001101010110011001101110000000100010111100010000011011101110111010010011000001100001011001001111011110000111101
1011100110000000011000101011001001110011101011111111110011100000000001111011010001001010000111100111000001111001101011011011100010000111010100101011101110011001011101110011000100110010100000010000000101010100001010110001011011000010010110111000001000110000
0011001110011000001000100011001101110001001011111011110011100000001001111011110001001010000111100011000001111001101011001010100010000111010000101011001110011011011101110011000101110011100000010000000101010100001010110001001011001010000110111100001000110000
1011100010000000011000001111001001110011011011101010000011000010000011011001010001000110001111100111000000110000101011010011000010000111011100101011111110001001111011110010000110110110100011010000010100000100001010110001011011000010100110101100001000100000
1011101100001000011000111011001001110001001011111111000011001000000011011011000001000100001101100110000001110101111011111011100000000111010000101011101110011001011011111010000100010010100000110000000100000100001010110001011011000011000110111100001000100001
0000011100000000110110000000100111100100100000001101010011111011010100001101001100101000000000100010011100100001010001111111010111001011110000010010100001100110000111001001101001110100001000100101011011100101100110000110010001010111010011110000000011001101
1011100010001001111000111101001001110101011001000011010001100010000101111111100001101010001011110111000111111001100011111000100010000111011101101011111010001001010111011011000100111110100011010000100001000100011000110101111011000110010100101100001000101001
1011100010000000001000111101001001110001011001000011010011100010000101111111100001100010001011110111000101011101111011111000100010000111011101101011111010001001010011111011000100111110100011010000100001000100011000110101111011001010010110101100001000100001
0000011110000001101110000000101100100100100010001111000101001011010110001101011000101100000000111000001110100001010001101111110101001011100000010110100101101110100111001001111000110100011010001101011010000100111100110100011001010111010010100100100011000101
0001011100000001100110000001101100000100101000001111010001101011110100001101011000101100000000100000001110100001010001111111110101001011100000010110111101101110100111001001101000110100001010001101010011100100111100110100011001010111010011100100000011000101
1011100100011000001000111011001100110001101001111011110001100000001101111011100001101010001111110011000001111101101011000010100010000111000000101011001110011001011001110011000001111000100010010000100011000100011010111001001011001010010110011000001100110000
1001000110000000101010101001001001110001101011011111110011100010010101111111110001011000001010111110000101001101110001000010110010000111110101001011110100001100010001011011000100110011100011010000000001000100111010110100011001011111010110111100001000101000
1001100010000000111010101001000100100001101110011110110010101010000101111101110101011010001010010011000111001000010011000010011010100111000101101011011100001111000001010011010011110001100011010100100000000111111000010101010000001110110011111100001100111000
1001101011000001101010011110010000110111010110100110100000100110011110111010111111000110000011011111100010011101000011110010011010100101001101001001010100001011010101001110010110011101100101101110101011010010110000010111101000000000110100111111001011111000
1000000010100010101100010010001000100110110010100101100010110010011111101100110110010110000011000101100111110000000011110100101010100001000101001010010100001000011001000110001110011110101011011010100000001111010000000101110001101010010100111110011001001000
0011001010011010101010111011000000110111011010100010100111100000011110111010101000001110001111001111100010011100001001010110001110101111100001001001000100010001011001010100010110011010100010100110001010000110011000111101101001101010100101111111001010101000
0011001110011010001000111011001101111101011000100011000011101000011110111010101001001010001110001111100111011100101001000000001110101110110000000001000000010110001001011100010111010010100010110110000011010110011010111101101001001010100000011110001100101001
1011010100111110001010101001001001111101011010001110000011101000010110101110010000001010001110100101100111111100101001010000001010101110110100110001111000111100001001011000100111010110100011110110110011001110011010111101111001101010100101011110001100101001
1011000100011010001000101011001001111101011000111111000011101000000101011111000001001010001111100111000001011100111011010010001010100110110100111011110000010000011001110011000111110010100011110000100010010100011010110101011011001010100111011000001100100001
1011000100001010011000111001001001111100011000000011010011100000000101011011110001101010001111100111000101011100101011010010010010000110010100101111111010011000011011110011000101111110100001010000100010010100011010110101111011100110100101011100001000110001
0010111001100001011101000100111101010010110011001011110001111111110000101100011001101000110101100100001001100001111011011111100101001011101000100110101101101111100111100000101100100110001100001011011001101001000100000000001000000011010010100010110001000100
0001011101100001011000000010111111010010100011111011110101111101110000101000011000001000100101100100000001110001111001011011100111001011010000000110101101111010101101100000001100000010001100001011011011111001000110000000001000000011000010110010110011010000
0011011001100001011100000111111111010010100011111111110101111111110000101100011001001110110101100100000001110001111001011011100101001011000000100110101101101010100111100000001100100011001100001011011001001001000110000000001000000011000010110010110001010100
0100100010000100110110100100100101100010011101001000001110110010000101010011000110111001101010110110001101101100010001110100010110001101111101110011111101100100000011110001100100110110011011010000000100100100111000000111010000010100010011000101010010101000
0100100011000100101100100100100101100010011111001000001100110010000101010011000110001001101010110111001101100100010101010100110110001101111001110011101101100110000111110001100100110111011000010001000100000100111100000110010010010100010010000101010010101000
0100011011000001100111000100100110000011010101001000111000111111000000100110001110000011110000010001011001001011010000011100110100011001101001110010001101100110000110100001101100110101001100001011011001000110101100000110000100011100010011010011010011001110
0000111000000101100101000101000110000010111100001001111000111010100100101110001110010011100010010111000001001001010000010111111000111101101001110111001110000110000100110000100100110010111010010011000011000110111100010010001100011110011011110011110110100000
0100110011000101110111000000110110010011001100011000110000110110001000100111001010001111110000010101010001000111010000010100011101101101100001110010001101100010000100101000100110100011011100000011111011000010101000000110000100011100011011010011010001101110
0100111001100101100111000101000110000011111100001001110000111010100100100110100111010011100010010101001001001111010000011110111000111101100001110111001110100010000100111000100100110001011000000010011011001110111000010100000100011110011011011011010000101110
1100101011000100111011110000111001110110011110000000001010100110000001010011000000000001001011111110001001000111010100110000100000000101010101001011110101100000010100010011000100011110010101010000001000000111110100100110010001010000010111010101001010101000
1111101111000100111011100010110001110111011010000010111010100110000001110111000000010001001010111111101101101111010100010000111000010101010101001011111111000000010100010011000100101110010111010000000101000011010100100110011001010000010111010101001010101000
0100000011000001000000100001000110000001001000011100011000000010000001010011000000100001001000100110001000100110010000011000000100001101001000000001100111100010000100010001101000010000001000100000001110100100000100010010000010000001001001000001000010101010
1111101101000100111000100000111001100110110010010000111010101011001101110110110100010010000010110111000111001111010100010000111000110001100101101011111110011100010100000001001100101010110011011000000001010010011100100111110001011100010101010111001111001010
1111101100011110111100100000111000100111110010011010111010101011001101110110110100010010000010010111000101001011010100010000111010110001100101110011011110011101010000000000001110100010110011011000000001001010011100000010110001011100011101011000001111001010
0110111111010100101111001010011100010111011110111000101010111110001010000110011110000111110011010101010001100111110100000110011100111100000001100010001101100010001100101000000110100011011100100111011111010010000100001111001110011000110010010111010111101100
1110101111001100111010111010101001100111011110110000111010100100001101110111001010010011100111111110101111111101101100110100110110011101010101001001110111010000111001010011011100011010011011000001001101010101110110100111110000011000010100010101111011101000
0101001010000001000000101001000110000010001000000010001001000010000001011011000000000001001000000110001000100101010000101000001100001101000000000001000110100010000000010001100100010010000000010000000111100110000000010010010010000001001000000001001110101000
0101001110001100110110110010101101100100011000110010111011110000010101011011000010010011000111111111101011110101001101110100100110011101010000000001100101110100001011011101110100010110011010000001000100010101100110000111110101010000010100010101111010101011
1010111101101010101000100001001011101111101010010000110010100110100100100111011110010011000010100101001111001100100000010001011000010100110101111110111001101100010001011011100100111110001011010111010001011100011000111010110001111110111101110000000001100100
1100001111000100000010100100111001010111001010001101111000001110000001110111000001001010010010111011111111101111010111000000100010010111000100001001110101000100010010010111010100001010011101000001001001110000100100100110111101001100000110000101101011101110
1100001011001101100001110110001001000010001101010100111000010010000001110111000010001001111011101110011011101111000110110000110100001101011001011011100101100001000000010111010100011010011100010000001000010100100100100110110110010000010101010101011010111110
1011011100100101000000110100111000110111010000001010111101101011100101111100100101111011010010110111110111011001110110010001100010010011001100001100010101001100110011001111011000000100110011011101000001001010110100100100111101101100001100100001101011000010
1011000100100001100100010101101010100111010000000010110111100011100111111100100100111011010110111111110110011000110101010001100010110011000100001100110100001100111011111011001000100100100011011101100001000010010100000100111101010110011101101001101000000010
1011000100100111000100010100101001001111010000000010100100100011100111110100100100011011010101111101111111010000101100010011101011110011111100011100110101000100111010101000101110101110100011011011110001001010011100100000110101111010010101101001101001000010
1001000100100010100000110000101011101111010000001010000010100011100111010101100100010011010100110110111111000000001100010001101011110011110100010100110101100100111010011000101110100110110011010000100000000110011110100000010101111010010101101001101000000010
1100110001101000100001010100111001001001010100000000111010000101000010100000001010110110100101111101101111010011001000010100110001001001011101000000110001100100001110000110111100001110001111001011110000011000100110100000110000110000010101000010010001011001
1100010101101000100001010100111001000001010100010000011000100101000000000000001010110110000000111101101111000011000000010100110001000001011101001000110001100100011110000110111100001110001101101011110000001000000100100000110001110000010101000000000001001001
0000100101000001100000001000011100010010001000000000100010110110001000110011100011000110100000011110100010000111010010010000011100111111000001000011000100000011000110010010000010100101100100100100111001010110100000100011100000010101110000011010001100100000
1001001000000000100000101000100001000010001001010010000111100010000001110011000100010000000010100111001101001101100000110000110000010111110101101011111101100100010010010011100100101111000011010100000000010100000100100011110001010000010110010000001010100000
1000001100000000100000111100000001000110010000000000000110100010000001010011000000000000000011101111001101001000000000110000110000000101011101101011110101100100011010000011100100101111001001110000000000100000000000000000110000010000010100010000001010100001
1010001100000010100100100010001000000110000000110000110110100000001001100000101000000000000101110100000001000001001000010000011001000000110101101010111100000000011000100011000100101010000001100111000001001010000010001000010000011001110110010000001000000000
1000001100001010100100100010001000000101000000110000110110100000001001110000101000000000000001010100000101001001001000010000011001100000100101101010011100010000010000100001000110101010000000000001000001100010000010001000010000011001110110010010001000000001
