0100011111000100100101000000111101000111001100011000111110110111000101100111001110010101100000010110011001000111010100010100010101011101100001100010101111100110000100100000101100100010011100000101011001100100110100000110000100011101011011010101010011101010
0100011111000100100111000000101100000110001100001000111110110011000101100111000110010111100000010110001001000111110100010100010101011101100001100010101111100110000100110000101110110100011000000001011001110100010100000110010100011101111011010101010011101010
0100011111100100101111000000111100010100000110101101100010110111000000100100011010001100110000000100010000100011010000010110001101101001100001110010001101100010000100100000001110100000001100101011011101111011000100000110001110011001110010010111010011001100
1001100100100010101000010011001010010110100000110010100011100010111010101000110001001111010001011100110101110001000011011011011000100011000101001111010100001001111001000010000110011010100001111110110001001010000000110000101011101010111100111010101100010100
1001100100100010111000010011001010110110000000110010100011100010111010001000100001001100011001011100010101110001000011011011011011100011000101001111010100001001111001010010000110011010100001111110100110001011100000111001101011101011110100111010101100010000
1011110100111010101001010011011010010111110010110111100111101100111010101000111001000110010111011101110001010000001010011011001000110011000001011101000100011001111000000010000110001010100100101110101000011011000000111000101100101010100100111010101100010100
0011001101011010001001110011011110011101110010110111100111011101111000101000111101001010100101000000100001011000101010001011001101110010000000001100001000011011111000101010001111001010100100101111001001010010001110011000001000001010101010111010101111010101
1111000100011110010000111011001011011101011000110010001111111000001011011011000001000001111111101111111011011110001010010000001100100110010100001101100010010001011000010011000111011110110100110100101000110100000010111011111110101000101101011001101110110111
1011100100001010100000101011001011111111111000110010000011101000111111011001100100010000001011010111000101001000100001010001011010100110110101111111011110011000011001010010000110111010100011110100100100100111011000111001110111111010111111111001001100100010
0100010011000100101111000000111100001100101010001101001011111111010011010011000110001100110000010010011000000100010101100100000101001110100001100010001001100110000001110000101011110000011100000001011000100111000100000110010000010001000010010101110101101101
1111100100011110010001111011001011011101011000100010000011111000100001011001000001000001110111101111111011011010101110110000001000000110010100001101100010110001111010110011011111011110110000110100100000110100001010011101111110101000101101010001111100110111
0110000011000101101111000100110100000000101111001101001001111111010011010111010110001110100001100010001000100101110101101100100101011111101001100010001001100110000111111000100010100111011100000001011111000101000100000110010000010101011010000100010011101001
0100010011100001001010010110110100101000111011101111100101011111110101100101010000001010000100001000111000110101011010101110100111101110001000010000000001100010000101011111111011000000001100000001111011001011110010101100000001110011000000001100100101011000
0101010011010101001010010100110100111000111111000111100101001101010111111001011010101100001100011000111010110100000100101100100111101100001000010100000001101010101010001110011011000100011100000001111010000001110010100110101101110101000000000100100001111001
1011101000000000000011010101100001000111110000000111110010101010010101111111010011011010010000110111100101011001100110011011100000010001011101011100111100101101111110010110001100011110110011011101000001000101011100010100111110001100010101100000011010100110
0001101101111010011110101011011110110001100011111111110101111100111100101100111100001010000111001001000001101000101000001011100110010010100000101110001000011010111001101001001001110000100100001110001000001011001110111101001000111010000010111010101100000001
1010101000000000010111010101000001000111110000000101110010001010110001110101100011011010100001110111101111111001100011011111100000010001011100111000111100000101011111110000101100011110100011010001000101000101001100010100110010001010001101101100011010000110
1010101010101000001111000101000001100111110000000101110010011011110001100001110001011010100001110111001101111001100011011111100000010001111100110001111100101101011011110000101100111110101011010110000101001101001100010100110010001110000101101100011010000110
1011001111011010001110101011011001111001100011111111111001111100011000101110111000001000101111100011000001101001101101001011100010010010110000111110001000011000111001101001001101101010100100001111001000100001001110111111001000011000010110110110010111000000
0011100110010000101010011001001100110110011010000111000011101010011110011000100001001100001010010100100110111001100011111010001010100011000001101001011100001110000101011110110110011100100011111010100001100111011000110101111001000111110000101110001000111000
1011000110100000001000011111001001110110111011000111110011101010010111111001010001001110001111100111000101100100101011110010001010100111011100101011111100001001011111110010000110111110100011010000110100001111011000110101111001101010010110011100001000101000
0110010111111010011110111010000011101100101001111101000111011000110011000001000001001100101111101000101000110100111011001110000111001110110000000000000001110101001001110100110111010010001100110000111100111101000010001111010000100010100110011001111100111001
0110000111011110001010111010110101111100101011111111001111011100010011011011000001001100101111101010101011110100101011001100100101001110010000000000000001110001001001110100010001010000001100100000101100100001000010101111000000100001100010000101110100111001
1011100010100011011010111111000001111011111011100111110001101010010001011001100001101000001111110111000100111000101011011011101010100111011100101011111100001001011011110010000100111100100001010100100100100111011000110101111011101010010110101100001000110001
1011100010011000001000101011001101110001101011111111000001001000011101011011110101001110001111100011000001110101101011001011100010000111010000111011001000011001111001110011000101111010100010010000100100010101011010110101001101000010010111111100001000110001
1001101001001100011000010111110011110011110011100011110011101101001000101000111001000010000101101101000001011001001111011001101010010011011100101110110110011001111011000010001100001111110100001111001101010001001100111000101001001010001100100010101011010000
1001111000101010001000110111010011110011110010100111110011001101101000101000111001000010000101111101000001011001001011011011100010010011011100001100110100011001111111000110001100001011100101001110000101001001101110111000101001101010001100111010101001010000
0111100110111011010110111011001100011000001001111110110001010000011000111101100001101011111111000001100001111000101011001010101010100110000000101001001000010011011001110111010001010000100000010010100010011111000010011101001000101010000111011111001100110011
0011100100111011101010111011001110110001101000111111110001101000101001111100110001001010000110011011100001011001001011001011100000000110000001011001000000011011011101011111010101010010100010011110100011001110101010111001001001001010000011111010001100110001
1111100010000100011000111111001001110011011011100111001011101010000011011011100001001000001111100111000001111100101011110000100010000111011100101011111100000001011011110011000100011110110101110000100100010101001000110111111001000000010100001101001000111000
1001000101000000001010011011001001110010101000111010000111011000010011011001000000100101111101101110000000010010001010111001000011100111010000001011100100011001111000110010010110010011100100111000111010100001100010110001011000000011100110111001111000111000
1001110100111010000000110011001011101001100001010011000000000001111110001100111001111001001110111000100110111000101000101011000010000000010100011101110000011101111010001111110001001110100011111010100000011001110010111001101101110010100101101010001001000011
0100001010000100101110000100100101100111111010001101111100111010010001110111010010011010100010110111001111101101010101011110110110011101111001010011101101100100000011011101110100110111001011010000000001010100110100000111010000011100010011000100010011101000
0011011011111000001110010010110100110000100011111111110001011101011000101100011001001000111101000000000001110001101011001011100111101011000000101110001001011011101101101000001001100011000100001111011001111011001110001100001000001011000010110110100111000000
0011011111111000001101011011010100010000100011111111110001010100011010001100111001001100111111000001010001110001101011000010001100101011000000101010001100011011111101101010000111100010100100001111001010101010001010001001001000001011000010111110000111011100
0011111111111001001011011011010100010000000011111111110001010101011010001100111001001110111101000001010001010001101011001011001100101010000000101010001000011011111101101010000011000001100100001111011010001010001110101001001100101011000010111110100111001100
0011011011000001001111000101010100010001000111101111100101010110000000101100011010101010110101000000000000110001111010101011100101001011001000100010001101101010000110100000001001110001001100001011011111001001000110010100001000000011000010100110010011011100
1111100110000110100111101010001001000010001001110010001010100010010011010011100001011101111011100111011101100100101011110000100000000111110101111011111100000001011000110011000100111010110011110000100100100101011000010111110110000000010111011101001000101110
0011000111011000001111001011011100010000001011111111100011110100001010011110111001001100111111000000010001111100101011001010001100101111000000111011001100011011011001100000000111110010100100001110001000000010001010011101001000001010100010110110010100101100
1111100110000100001000111101001001110111011000000011110011100010000101111011110001000010001011101111000101011001100011010000100010000111010100111111110110001001111011010011000100011110100011010000100000010100011000110101111011001010010100011100001000110000
0011100101011010011101111011001100011000101101111010000011010100001010001110101111001010101111000001010001011101101010000011001100101110000000101011001000011011001000110010000011010010100100101110001010001010000010011101001000001010100010111010011100101101
1011100010000001101010101100100001110010111010011010000001101010010111011011010101001100001000110110001000100100010001111011010011000111011101101010111101101000010001010011000100111101000011110001000110100111011100110111011011000101010110110100001010101000
0011000000000001001111000011000100010011001011111011100101011110011010111010101011001110111011000111000001101001101011001110101100100111101001100011001100010010010101111000000110110000100010000010101111010111000000010100001000101010010010111010011100111100
0000110000111011000000111101010110101100010000000000000000000101011100000000101111110011001010011001110110010010010000100101111110001000001000010101010010011111100000000111110001001101111011101010100110001011111000111001101101110110000001101011100101000010
1111101111001100001100111010111001110000101011111111111011011100000001011011010001000000101111100110001001011101101111110000100100011111010000101011101111110001001001110011001100110010011100000001001101100000001110000111010010001001011110010101101010101000
1000110000110011100010111101100010101111010100000000000000000011110110000000101111110001001010011101101110010010010010110001011010101000001100010100010011100111000010000111110000011101001011011010110010001111111000101001110101100110000001101011100101000010
1011100100000001101010011001000001110110111000000111000011101010010011011001010001101100001001111110101010110100000011111011000001100111010101001001110100101100101011011010000110011100000011110100110100100101001000110101111001100011100000111000001000100000
1011100000000000101010111011001001010110111000100111000011101010010011011011010001101100001001110110100100110000101001111011000000000111010101111101111100001000111101010010000100011110100001111000000110100101001000110101111001000011110101110100001010100000
1111100110111010001010100011001001011110111000110111110011101000011001111011100001001010001101100111010001101001101011111010001000100110010101101011111100011001111000110011000100111010100001011000100111001111001000111101011001001010110110011100001100110100
1010110000101011100011011101000010101110010100000000000000000010111110000000100111111101011000111100100110010011100010011111100001100000001101010101111000000101010110000110110010001100100011011010010000001101011000011001110101101111010101101010001000000110
1000110001111011000000110110110010001001000100000000001000001101101110000000101111111000000110011001110100010010001110101001000000010000001100001100010000011100111010000111011001001101110011011110100010101000111110101000101100100000101100101010111111000011
0001010001010001001010111011010110111101101110110111000001001100011110011010010010001110001111011001110000111010001010001011001110101100000000011101000000011011111000011110010011011001100100101110111000010011110010111101001101111010100000101010101100100000
1001110000111011100010011101010010111101110100000001000000000100111110000100111111011111001010011001110110110010000010001011000010100000001101011101010000011111111110001110010011001101100011111110010010001011111000111001101101101110101101101010001100000010
1000100001011011000001110010110000011001000100110000001000000101101000000000111011111000100110011001110110110010001110101100000001010000000000001100010001011001111000000111001001001001111111101111101010101000100110101100101100110000101100000010110111000011
1110001111000100001111101110001001000011111011111101111011111010010001110111000001001010100111100111001001101111101011011000100000000111110100100011101101100001001011111001100100110010011101010000001001000101001010000111010000001000010110010101011010111100
1010110001111011100000110100110001101101110000000001001000000101100100000000101111111000000000001000101110110010000100100111100011010000011100000000110001110101011010000111111001001100001111101011110010101000101110101000110010100101001100101010010111000011
0010100000111011100010111101000010101101110100000000000000001001111110000000111111111111000010011001100110110010000110101111001010101000001101010101010000011110101010001110110011001100101011111110100010001111111000101101101101100110100001101010000101000011
0000111001111011010101010100110100001001000100000000010000010101001000100100101011110000100100011000100110010011001100100111100101001000101000000000010011111110101010000101111001001101001100001011011011101000111110101010100010100101001000100110010111000001
1011101110001000001000110011001001110000101011111111111011000000000001111011000001001100000101110110000001111101101001110010100011010111010000101011101110011000011101110010001100110010100000010101000001100100001110110110011011001001010110010100001010100000
0011101111000000001110100010001101110011101011111011110001111100010001111011010001001010100111100111001001101101101011011010100110001111110000101011101101011000001001110001000100110010000100000001001101010101011110010110011001000000010110110100001010101000
1011100000000000001000101111001001110011111011101111110011101010000001111011010001101000001111100111001001101001101011011010100010000111011100101011101110101001011011110011000100111110100001010000000101010100001000110101011011000010010110111000001000110000
1011101100011000011000111011001101110001101011111111110011100000001001111011110001001010001111100111000001111001101011001011100010000111010000101111101110011001111001110011000101110011100000011000000111010100001010110001001011001010000110111100001000110000
0100000110000100000110000000100101100000001000011000001101000010000101010011000110110001000010100111001000100100010101000100010110001101110000110011001111100110000101110001100100110011011010010000000010100100110010000110010001010100000011010101010010101010
0011101110011000001000111011001101110000101011110111110001011000001101011111111001001100001111100010000001111101101011101010100110000111010000101011101100011001011101110010000101011010100000000000001111100101011110110111001001001011000110110110001010111001
0011101110011000001000111011001101110000101011110111110001001000001001011011110001000100001111100010000001111101101011101011100110000111010000101001001000011011011001110010000101010010100010110000000111100100001010111001001011001011000010111110001000110001
1011101110001000011000111111001001110011001011111011000011000000000011011011010001001110001101100110000001110001101011110011100010000111010100101011101110011001111011110010000110010010100000110000000000000100001010110001011011000010100110111100001000110001
1101000010000000101010000011000000110111001010111111101101100010000111111111110000001110000010010111000001001101010001010010011010100111000101111011001100001000010001011010000110111000100010110000000010000110110000110110011001011100010110011100001110101000
1111100110000001011000111101001001110001001001000111010001100010000101111011000001101010001011110111000101111101101011110010100010000111010100101011111100000001010011111011000100111110100011010000000001000100001000110101111011000010010110001101001000101001
0101000110000000100010000001001101110111011000011111100011101010010111111111010000011110000010010111001001100101010001011010011010100111100001111011001100001000000000010000000110110010100010110100000000010111011000110111011001011110110011011100001100101000
0011011101000000011100010010111101010010100011111011100011011111110000101000011001101000101101100100000001110001011001011011100111001011010000000110101101101011100101100000001100000010001100001011011001101001000110000000001000000011000010110010110011010100
0011011001100001011100000110111101010010100011111111110001111111010000101000011000101100111101100100001001100001011001011011100101001011111000100110101101101011100111101000001100100110001100001011011001101000000100000000001000000011000010110010110001000100
0000011100000100101110000000101110000110001010011000100111111110010110101010001110000001110000010000011001100001010001001101011111111011100001110010001101101110000101100000101110110010001100101111011101100111011100010110001100011111110010110011110111001100
1000111100100000100001000001001010000111010000001111100011100011000010101100100001000110000000010100011111100001010010011011011001100011000101011111011100101110100100001010110110110100111101110111010101011010101000100100110111001111110001111010100001000100
0100011111111010101101010000111100101101100110011000001110111101001110000110111110010100100010010101100001001110010100000100001011111000100101000000011011011111101100100000101111000010001111101111011010101010000100001010000110101000110000010111110111011000
0110011111011110101100100000111100101101000110011000001110111101001010000110001110000101010010010001110101001110000100100100001111111000100001110000011011011111000100000000111111100010001100100111001000110010000110001010100110111100100010010111010111001001
0001100101000100101000001101001110010010011000100000101000110110101000111011011011000110110000011010010010000111010110100001011100111101001001000111000100001010100100010010000010110100110100100100011101010110101000110011100000010101111001111010001100100100
0101111111100100101101001001011100010110000110011010100001110110000010001000001110000100110000010000011000000011010000100100011101101001100001100010001101100010000100100000001010110000001100101111111100101010001100010000001100111111110010010110110111001100
1001110110100100101000001100101100110010000010011010101001100011000111101000010101010110000000010101000100000001010011100001011010110011001101101110011101001001110101100010000110100000100011111011110001011010111000000001011000100100111110010100100101010100
1000010100101010100000001010001001001100000001010000100110000000001010000000101000100000000110011000000100001000101000110100010000100000110101000010110000110100011110000000100110101010000001100111010000111000000010001000100000110001110110001010000000000001
