0101001010000000000000100100100100110001011100001010111001000010000101111111000000000010000000100011001001000101010000000000100100011101001000000000000111100010000010011001001000010101000000000100001000000100110100100010010000011100000001000101000010101000
0101000100000100100001110000100111010001001000001010111111010010000101111111000010000011010000101111111001001010010100010100110100111100010000010000100111100000000000011100010100010110010100010101001000000100110000010010010100011000001011000001110010101111
1100101000000100100000110100000001100101011000000000111000000010000101110111000001111011000010111111110101011100000110010000100010010101011101001000110100000100000010010101010100011111010011010000000000000100111100110110110100000000000001000001000010100011
0100011110000100100111000000101100000100001000001000101100110011000001100111000110010001100000010110011001000111010100010100010101111101100001110010101111100110000100110000101110110010011010110101010001100110110100000110010000011101011011010101010011101010
0100011111100000101111000000111100010110000110001101100001110111010010100000011010000100110000000100011000100111010000001110001101101011100001010000000101101010000100101000101110110000001100001111011101101010000100000110000000010001010010010110010011001100
1001100100100000111000011011001010110110110010110010100011100010111110101000100001001101000001011100000100000001000011011011011011100011001101001111010100001000110100010010000110111000100001111110110001111011110000110000111101101111110110111010101100010000
1001110100100000101000010011000010010110100000110010100001100010111010001000100001000101010001011100010101010001000011011011011001100011000101001111010100001001111101000010001110011000100101111110010011011010100000110000101111101011110100111010101100010100
0100011011000100001111001000110100000100101110001101001011111111010011000011010000001100111000000010011000100110110101000100001101101110100000000100001001100110100001110000100010100001011100100101001100100011000100000110010000010101111010010101110011101000
0001000100010110100111101011001110000011001100111010100011110010001011011011100010010111111011000011011001101100010000000100001000100111100001110011001110010000000000110000000111110010110010110100100100110111111010011011010010111010100111011000011100100110
1111100100011110010001111011001011011101011100100010001011111000000011011011000001000001111111101111111011011100101010000000001000110110010100001101100010110001101000110011000111011110110010110100100100100000000010011111011110101000101101010001111100110111
1111001101011110010001111011001011011101111000100010001110111000001011011011000011000001111111111111110011011010001011000000001100110100010001001101100010010001111000010011000111011110110000111100001000100100000010111011101110001000101101010001101110110111
1100000111000100101101001000110001100110101010001111001001111110010011010011010000001100101001000110001000100100110101011010000101011111110101110010101101100000000001110000001110110100001101100101001100100111000100000110010010010001110010010100010110101000
0110111011000101101110000100110100110000101111001101101001011111010001010011011110101100100001100010001001100101110101101110100111011110100001100110101001101110100111101000101001100111011100000001011110100001001100100110000000010001011010000100010011110001
0101110011000101001010010100111100110000111110000111101001001101010111111001011011101000001100011000111010111110010100101010100111101100001000010000000001101010101110011111011011000100001110000001111001100001110010100110100101110101000000000100100001101001
1100000111001100110111000010101001000100001100111000011010110010010001110011000110101011110001110010001001100110010101110100110001000111110101100011101101100100010001111001101100110000011001010001010001000101000010000110010000010001010111010101011000101110
0110010011100001101111000100110100100000111011011101101101011011010011010011010100001100100000010010001100100101110101101110010101111110101101110010011101100110000111111100111010110001001101010001011010101111000100000110010000010101111010000100010011101000
0100010011100001001010010100110100101000111111001111100001011111110101100101010010001000001100011000111010110101010000101010101111101110001000010000000001100010000110011111111011010000001100000001111011001011110010100100010001110111000000001100100101001000
1011100100000000001000111111001011110010111001110111000011101010110111011001100001001100011111100110010000110000101011111011000010100111010100101111111100001000111011110010000110111010100001111100100100110001000010110000011111001011110110111000101000100000
0011000101000000101111000000111110010010101110001011101101111111110111111111011110001100110000000011011001100010010100001111010101111101000000110100001101101010100000100000001010100000011100101101111100100011001100000110001100010001111010110000110111100100
1001100100001000000000111011001011110000101000110011000111101000111111011000100001001100001111111110010001110000001011111011000010100011010100001111110100011000111000110010000110011010100011111000100100110001010010110001011111000011010110111000101000110000
0001101101011010111110101011011100110001100111111111110101111100111100101100111110001010000111010001000001101001101100001111000110010000100000001111001000011010111100001000000001100010100100001110001100101001001110011101001000011010111010111010111110000001
1011101110001100100011110100100001100101110100000101111010101000011100111110111111011010000000110111100101001111000110011011100000010001011101011101111100011101111110001000001100001110110011011101000001000000011100010110111010001000011101100110011011100111
1001101111011010001010101011111100110001100011111111111011111101111100001110111000001000001111001001000001101000101100001011010110010011100000001110000000011010111001101001000101100010100100001011001100100011001110111101001001011000010110111110101011000001
1011010010100000101110000000100001100110001010001111100101111010010111001101010000001110000001000110001000100001110001111011011011100111110101100010101101101100000101111000101110110100001001110001010101001111011100010100010011001111110010110100000100111000
0100100111000000101100001000110100110110101110000101001011111110010001010111010100001100101001001010001001100101010101101010001111111110100001110010101101100110000101111000101110110110001100100101011100100011001100100111110010011001110010010100010110101000
1011000110000000101010000011001001110110011010101111100011101010010101111001010000001110001001100110001000100101101011110010000011100111110101101011101100101001011101110010000110110110100000110100110111000111010000110100011011011011110110011100001000101000
0100010111100000101111000000111100111100101010011111100101111111110001101101010010001010100000000000001001101101010000001010001101101110000001110010001101100010000000111000000011110000001100100000111001001011000000000100010000111011110010011100010100101000
1111000110000100001010001011001001110111011010110111100011101010010101111001010001001110001101110110000000100000101011110000001010100111010100101011111100001001011101110010000110111010100011110000110110000111010000110101011011001011010110011100001000101000
0001100110001000101010011011000101110100101010111011000011001000011111011011010001011110001010011110100010110100000011001010011110100101010001010001000100011001010001010110010110010011100010100100110100000111110010110101001001011110100100111100001000101000
0110010011011010011110111110000101101100111001101101001111011000010011000011000000001100101111100110101000110100111011111000001111101110111000000000101001110101001011110101110011010000001100110100111100110101000010101111010001100001100010000101110000111001
0011100000001000101010010111000111110001101010110111110001001000111101111000110001000010000000111111100111011001000011001011100010000111011001001101011100011001110001010110010101011011100010011100100101000100001010110000101011001110010100101000001000100001
1011100010100011011000111111000001111011111011000111110001101010010001111001100001101000001111100111000101111001101011011011101010000110011101101011111100001001011011110010000000111100100011010100100100101111000000111101111011101010010110101000001000111000
1001101001100010001000010111010011110011110010100111110011101111101000101000111001000010000111111101000101011001001111011011101010010011011100001110110110001001111011100010001100001111110101011111000101011011101100110000111001001010001100101010101011010000
0011100110011011010110111011001100011000001000111110110001010000011000111110100001011011111111000001100001111000101011101011101000000110000000111001001000011011011001110111010001010000100010010010100111011111001010011101001000101010000011111110001100110111
0101001110011100111000111011001100110000101010111111111001101000001001111111110001001010001111111011000001111101001011100000110110000111000001101011000000011011110001110011000101010010110100010100000111010001001010110111001001001000010010011111001100101001
1111100010000000010010111111001001010011011001101010000011110010010011011011100001001011001111100111001000111100101011010000000000000111011100101011111100100001011011110011000110111110100001110100100100010101001000110111010001000010110111011101001000111010
0101100111011100111000111011001101110001101010110111111001101000011001111111110001001010001111101011000001111101001011100000100010000111010001001011000100010001011001111011000101011010110100010000000110010001001010110111001001001000010110011101101000111001
1001100110001000101010111011001001110010101010110111000011101000011111011011110001001100001111111110000000110000001011111011000010100111010100011011110100011001011001110010000110011010100010110100100100110101111010110101011011000010100110111100001000110000
1111100111001100111000111011001001110001001010110010001011111000011001011011100001001000101111100111000001111100001011110000100010000111010100101011100100010001011001110011000100011010110100110000101100010101001010110111010000001000010110011101101000111000
1101000100100010101010111011001001111011101010110111000011101000011111111011110000101010001111111111000000110000001001011010001010100111010101011011100100001000011011011010000110011001100000110100100000001111010010110101011001101010100110011000001000101000
1110100110011110010110101010001001101101011100000000001010000000010011010011100111010011111110110111101101111110101000010100001010100100110100000001111000110101011010010000100111011010111011110100100100010111001010011111110110101000100101001101011100101011
1001000111001000001010011011001001110000001110111010000111010000010111011001000001000101001101101110000000010000001010110011000111000111010000001001100110011001111000111010000110010011100100111000111010100000100010110001011000000011100110111001111000110000
0011111011111000001110010011110100010000100011111111110001011101011000101100011001001100111101000000010001110001101111001011101111101011000000101110001101011011101101101010001101100011000100001111011001101011001110010101001000001011000010110110100111010001
0100100010000101011110101100100100100000101011011101001001011010010111011011010101101100001000100010001000100100110101101110110111001110111000100011001001101110000011110000100001110001011010010000110110100101111000000111010011010101010010000100000000101001
0010011011100001011111000100110100010001100011001111100101011111010000101110011000101010100000000001001000100001110000101110100101001010101000100000001001101010000111101001101001110001001100001011011011001001000110000100001000000110000010100110010111011101
0011011011100001011111000100110100010000100011101111100101011101010000101100011000101010100101000000100000110001111000101011100101001010001000000000000001101010101110101000001001000101001100001011011111001000000110010100001000010011000010100110010011011101
0011011111111000001101011011010100010000100011111111110001010100011000101000111001001100111101000001010001110001101000001010101100101011000000101010001100011010011101101010000011110010100100001111011011101011001010111101001001001011000010111110000111001100
1000010000111011000000001101010000101100110000000101000100000001111110000000111000111100001000001000100110100010000000101011000010100000001100011101010000011100110010000110110001001101101011111010110110111001110000101001110001110111000101101010001101010011
0011011011100001011111000101010100110001100111101111100101011110010010101100011000101010100000000000000000110001110010101011100101001011001000100010001101101010100110100000001001110001000100001011011011001000000110010100001000000111000010100110010101011100
0011100111011010001101001011001100010000101111111111100001010100001010001110111001001110111111000000010001111100101010000010001100101111000000101011001100011011011100110010000111110010100100001110001010000010000010011101001000001010000110011110011100111100
1000010000111011100010011100100000101100010000000100000100000001110110000000101000111101001010001000101110110000000010101011000010101000011100011000010001111100000010000110110001011101001011111010110110111101110000101001110001100110000101101010000101010011
1011100100000000111000111101001001110111011000000110110011100010000101111011100001100010001011100111000111011100100011011000100010000111011101101011110110000001011011010011000100011110100011010000100000010100011000110001111011001010010100011000001000111000
1011100100000100111000111011001001110111011000100011110011100010000101111011110001000010001011101111000101011001101011010000100000000111010101101111110110000001011011011011000100011110100011010000100000010100011000110001111011001010000110011000001000111000
1001100010000001101010101000100001110010001010000011000101101010010111011011010001101100001000110110001100100100010011111010010011000111010101101010111101101001010001010010000100111100000011110001000110100101101000110111110001000101010110010100001011101000
0001000010000001011100000011000100110011101011111111100101111110011110111010111110001110001011000111000000001001101011001111001110100111101001100011001100011010010101110000000110110000100010001010101011010111000000010000001001101010000010111110011100111000
0011000100011010011101101011001100011000001111111010000111010000001001011011100110000010101111000011000001001100101000100101001100100110100000101011001010011010011000110000000011110010100100110100101010000010000010011101001010111010100010111110011100100001
1111101111000100001110111010111001110010001011111111011011011100000001011011010001000010101111100111001001011101111101110000100110011111010000100011101101110001001001110011000100110010011100000000001100100101001110000111010011000000011110010100001010101000
1011100000000001101010011001001011111110111000000011000001101010110011011001000001101100001001111110101010110000000011111011000011100111010101001001110100101000001111011010000110011100100001110000110110100101001000110101111001100011100000111000001000100000
1001100000011111010010111011010010111101100000000010010000001101011100001000101001111001001110011000110110111010000000101001100010000000000100001101010000011101111000000111010001001001110011001010100010001000110010101101101101110110001101101010101101000011
1011101110001000101010111011001001110110111000100011000011101000011011011011010001001100011111110110100100110001101011111000000010000111010101101001111100010000011101011010000100011110100001111000000110100101001000110101111001000011010100011100001000101000
1011100110111010001010100011001001111110111010110111110011101000011001111001110001001010011101000111000001101001101011101011001010100110010101101111111100011001111001110010000110111010100001010000100111001111001000111101011001011010110110111100001100100000
1011000100011010001010101011000000111101101011111111100111101000011011111110110000001010011110000111000001101000101001001011011010100110100000100111001100011000110001010000000111110010100000111110100010010111001010111101001001101010110110111010001100110100
0001000010010001001010111011000100111101101010100011000001001000011110011011010000001110001110011001100000110100011011001111001110101110000000010101000000001011101101011110010011010011100010101100110100010011110010111001001101111010100000101010101100101000
1000110000111011100010111101100011101101010100000000010000001001110100000000100111111001001010111001101110111010000110111101110010010000011100000100110000110101110010000111110001001101111011011010110010101101111000101001110101100110001101101000101101000011
1110101111000000001110100010111001100011101011111111111011111110010001111111010101101010100111100111001001101101111011011010100110010111110100100011101101101001000011110001000100110010001100010000001101010101001110000111010000000000010110010100011010111000
1010111010100011101000110100110001101100010000000001011000000011100100000000101001111000000010111100101110111010000111110011010011011000011101000100110001101101100111001111111000001100001011010011110110101000101100101100110001100100000101101110000011000011
0000111010110011101000110100110100101100010000000100010000000111001000000000101011110000000000011000100110010000010011100110110111001000001100000000010011101111100011000111111001001101001011001011010011101010101100101000100011100101000000100110000111000001
1000100000111011100010111101000000101101010000000001000000001001111110000100100011011001001010111000100110111010000110101111011010100000011100001101010000011101110010000111110011001101100011111110100100101101111000111101111001100110100101101010001101000011
1011101100000000011000110011001001110010101011111111110011000010000001011111000001000100000101100110001001011101101011111010100011010111010100101010101110101001011111110011001100110010100000010001000001100100001110110010011011000001000110110100001010100000
1011101110001000001000110011001001110000001011111111110011001000100001111111000001000000000101100110000001011001101011111011100011010111010000101011101110011001011101110011001100010010100000010001000001100100001110110010011011000001010110110100001010100000
1011100110000000001000101011001001110011001011111111110011101010000101111011010001001010001111100111001001101101111011011011100010000111010100101011101100101000011011110011000100110010100000010000000100010100001010110101011011000010010110111100001000101000
1010110010111011100010111100100001101100010010000001000000000001110100000000110001111000001010110000101110110000000011111111010011000000011101000000111001101101000011000111111001001100101011111011100000101101111000001101110001100110110101101110000101010011
0011100110001000011000101011001101110001101011111111110011101000001001111011110001001010001111100111000001111001101011001011100010000111010000101011101100011001111101110011000100110011100000010000000101010100001010110101001011001010010110111100001000110000
0100000110000100000110100000100101100000001001011000001110010000010111010011000110110001000000100110001000000100010101100100010110001101110000110011101101110110000001110001100101110010011010010000100010000101110010000110010001010100000011010101010000101011
0010110010010011111000011101000100101100010000000000000001000010001010000000111001101010001000001000100110110000010011101010100010001010001101000001010000101111000111000111110001011101101011010010110110001100101000111101100011100110000000101010000101000001
1010110010100011001000011101000000101110011010000110010001000011000010000000001001101110001000100100101110110000100011111010100010001010001101101001111001101111000111000111110000011100001011010010110110001100001000101101110011100111010000001110000001010001
1011101010001000011000111111001001110010101011110111000011000000000001011011000001101100001101100110000001110001101011110010100011000111010100101011101100011001011011110011001100011010100010010001000100000100001110110101011011000011000110010100001010110001
0101001010000100101000000001000100110011001010011111101101100010010111111111010000000110000010010111001001001101010001010000111110100111100001111011001100000010000101111010000110110000110010110000000011000110110000110110011001011100010011011100001110101000
1011100100000001011000111011001001110011001001001011010011100010000101111011000001101010001011110110000001011101111011110000100010000111010100101011111100100000010011110011000100111110100011010000000001000100011000110101011001000010010111011000001000100001
1101001010000000101010000011000000110111011010111111101001100010000111111111110000001110000011010111000001001100010001010010011010110111000001101011001100000000010001111010000110111010110010110000000000000110110000110110011001011000110110011100001110101000
0111100110010100001000111011001101110001001011110010110011101000001101111111110001101010001111110011000001111101101011100000100010000111010100101011111100010011011001111011000101111010100010010000000001000100011010110101011001001010010110011101001100100000
0000011010100001000000000000110100000000000010000000111000000111010000100000011000100000000000000100001001000001010100010010100101011001000000000000100101101010100100000000101000000000001000001011010011101001000100000110000000000001000000000110000011000000
0001010100000000111100000011001110110110101010111111100011111110100001111101011001000110100001000110001000000001010011001011001111101111000001100010001100101011100101111010001010110000000100101101011001010010000000010000001000001011110010110000000100110000
0011010100100000111100011011001110110010101010111111110011111010110001111100010001000110100001000110000000000001011011001011001101100011000001101110001100001010100101110010000010110000100100101101111001010011001000010001001000001011110010111000001100100000
0000011100000100101110001000101110100110000010011000100111111111010110101011001110000101110000010010011000101001110001001101011111111011100001110010001101100110000101100000101110110010001100101101011101100111011100010111000100011111110010110001110111001000
1000111100100000100001000000001010000110101000001111100011101011100000100100100001001110010000011100011111100001010001011011010001101011100101010110011100101110100101001000100110110110011001110111010101001110101000100100110111011111110001111010100001000100
0100110110111100101001010001001100100110110110000111100001100010001110100100111001000110001000010100100111000001010010000010011101101011000001010101010110011111100100000110110110000010111101111110110101001010111000111000100010001111110000011110001100010000
0100011111111010101101000000111000101111000110010000001110110111101110000110111110000100100010011101010111001111000100000110011011111000100001000010010111011110000100100000101110101010001101101111011010101010100100001010100110111000110000010111110111001000
0100011101000100000000000001011110010110011000001000100110100110001010101010011000000011011000010000010000001111010000110000011111101100100000110010001110100010000110010100010010110100011100100111011101010110101000110001101011011111101011010010000100101000
0001001101000100100001111110110110010101010101110000011000000101001010010010101111110001110011111011110100010010001110000001010000010001001101011100010110010011110000000011001001001001110100101101001000010000100110000011101110001000111000000011111111010110
0000100101000100100010001101001110010110011000000000101000110110101010111011001011000011110000011110010010000111010101010001011110111111000001110111001110001010000100010110000010111100110100100110111101010110101000110011100111011101111001111010000100100100
0001110110100100111000001000101110110110000110001010101011110011010111101000010101010111110000010100001001000001010011100001011011110011000001100110001111101010100101100010000100100000110010111101110101011011111000000001011010100111011010110101101001000000
0001011111000100001101000001111100010110000110001010000001110111000010001000011010000101110000010000010000100011110000100001001101101011100001100110001111101010100100100000001010100000000100101101011101110010001100010000001110010111110010110111110111001100
1011110100101110110101010010101011000111010000110010001101100011010111101000100100011111010011010101010001110000000000000001001001110011110101100110101101010001111100100100000110001010110011011011110100011011010000000100011101101010101110011001101101010110
1110011101001110000001000010111010111101000100010000001110100101101110100010101100011001000111000100010100111111101100010000010000111000010100101011111001010110011110000010001110101110001111101110001111111010000110001110101110111001101010011011100011000011
0011011101110000100001010011001111011100001010111010010011110000000000001000001101100001111001100000010001110001011011100001000101001010010001101110101000001011100111111011000001010010100100111111011101101000000010010000001100001011110010110010100100110101
0100011111011110100100110000111100111100000101010000101010000101001010000010101010000001000101011100010100101110001100110000001111111000100001001010010001010110001010000001101110101110011101101111001100110010001110101010101101010001110000000111110011001011
1100011111111110101101000000111001111100000111010000101010000101001110000010101010010001000100011100000100101110001100110100010001111000110101001010110001110100011110000000101110101110011111101111001100111000001110101010101100110001110000000111110011001011
1100111110101101100101000000111001101000000110011000101000100101000110000110001111110000101000010100100110001101010110010100110011111000010101100100111001100111100110000000101110100101011111101111010001111000111110000010101000101101110000010110010011011001
1000111000100101100101010000101001000000000110001000001000110011100111100000000111110100100001110000001011000011010110000101110001010001010101101110111001101101100100100010101001100101011011011111010001101000111100000000110000100111011101110000010111010111
0100110001010001100000001100110100011000001000000000111000100111001000010011001100000100001000010110101110000111000100010000011111101100100000000000001101100111000110000001111011101100001100100001011001100010101110001010100001010101111000000010000011111001
0100110001010001100001011110100100000010011100101000111100010011000001010011000110100100101100011010101011000111010000000100011101001101001000000000000101100011000100010000100001010000001100000001011001100110100000100011000000011101011011000000010100101000
0010100001000001100101010010100001000110001100110000010010110111100001010001000111110110100001100110101001010011001110110101100101011101100001100000101101100011011100110000001000011101001100000001111001000100001100010000000000000011011011110000011100110000
1010111100100001000100000000111001000110010000001010100001100111000010100000001100010110000000000100000100001001110100010100100000110001100101100010111101100101000100100000101110100100001011111111010011001010001100000001011001110001100110010010010011000000
1011111100100000000100000000101101000110000000001010100011110011100011101000000110110110100100000101001001000001111100010100100101010001110000100010101101100101001100100100101110100100000010111111110011001100001100000000010000100011000110010000010001000000
0010111101011010000100011011010100001100001100101000110011110100000000000011001110000000101101000100101001011111101000000100001101101110110000100000001001110110001100100001101101000010001100100011001011100010001110011010001000000001100010010010010111100001
0010011101111000000100001011111100011100010001111000110111010100001000100010001110000100101111110001000001010001101000000100001100101000100000100010001001110010001110100000000111100010001100101011011011111000000110001010001000011001100010000010000111000001
