0100011111000100100111000000101100000110001100001000101100110011000101100111001110010011100000010110011001000111010100010100010101011101100001110010101111100110000100110000101100110111011000100101011001100110010100000110010110011101001011010101010011101010
0000011111000000001101000000011100010110101110001101100001110110000010101010011010001000111000000000001000100101010001011110000101101111100000110010001111101010000101100000101010110000001100101111011001101110010100010000001010010011000011110110010011001100
0000011111000000001101000001011100010100011110101000100101110110000010101010011010000100111000000100010000100111010001001110010101101111100000110000001111101010000101100000000100110000001100001111011101111010111000010001001010000011000011110110010001101100
1001100100100000101000010001001010110110010010100010100001100010111111111000110001001101001001011100000100100001010011011011011011100011000101001111010100001010110101010010000110111000100011111010110101101011110000110000111111100111110110111010101100010000
0100111011000100101111001000110100010110101010001101001001111111010001010011010000000100101000010010011000000101010101010100000100111110000001000110001101101010100001110000100010100010011100100101001001100001001100000110010000010001011010010100110111101100
1001100101100000101000010011011010010110100010110010100001100010111010101000110001001100010001011100010100000001000011011011011001100011000101001111010100001011110101000010000110001000100101111010110101101010100000110000101101101011110100111010101100010100
0011000100010000100101001011001110010010101100111010100001111010111111011111100110000101111011000111010001001000010000000100001100100111100001110011001110010010000000110000000110110010100010110000100100100111011000010001001110101010101011111001011100100110
0111000100010110100101101011001110010011101100111010100111110000001011011011100110000111111011010011010001101000110000000100001100100110000000110011001110010010000000110000000111110010100000110100100100110111010010011001000110111010011011011001011100101110
1011100100011110110001111011001011011111111100110010001011111000001011011011000011000001111111111111110011011100001110010001001100100110010001001101100010010001111000010010000110011110110000110100101000110110001000011011111110101000101101011001101110110110
1111100100011110010001111011001011011101011100100010001011111000000111011011000001000001011111110111111011011100101110010000001000110110010100001101100010110001101000110011000111011110110000110100100000110000001010011111011110101000101101011001101100110111
0010011011010101101111000100110100001000100111011101111001011101010001000011011110101000100000100010001011100111110101101110100101011110101001100110001001101110100111100001101001100111011100000001011101000001000110000110000000010101011000000100010011110001
1011100100000000001000011111001011010010111001100011000011100010110011011001100001001000011101100110010000110001101011011011001010100111011100101111111100001000111111111010000110111110100001011000100101110011000010110000011111000011110110111000101000110100
0001111101111011001110101011011110111001100011111111100101111100111100101100111110001010001111010001000000100010001000001111001100111000100000001110001000011010111000101000000001100000100100001110001110101011001110011101001000110010011010111010111110010001
1011101110001000001011110011110001110101100010100111111000101101011100111110111101011010000110110111000101001001101110011011100000010001010100111101111100011001111100001010001100001110110011001111000001000000011100000110101000001000001101110110001011000100
1010111100101010010111110001001001000101100001000101110100111001111000100100110101011010100011110101000101111011100101011011100000010000010100111010111100001100010000100001101100111010100011011110000001001101001100011100110010101010011101111110011010000110
1011010010100000101110000001000001100110011010001111100101111010010101111001010001001010000001000110001001100001110001111011001011100111110101100010111101101100000101111000101110110111000001110001110101001111011000010100010001101011110010110100001100111000
0110001111000000101111000000110100100100101110001101101001111111010001010111010000001100100000010010001010100101110101001110001101111111100001100010001101100110000101111000101010110100001100000001011100100111000100000110110010011101010000010100010110101000
0101000011011110001010101110110101011000111010101111011011001100010001011011011000101000001100100010001000100100001100100000000101001110011000000000100001110010001011010001000001000010011100000001111100100001000010001111000010001001100010000101100010101001
0100010011111010010110101100000111001100101000001101000011011000110001000001000000101100101101100000001001110100011001101110100101001110110100000000100001110100000011110100100001010000001101110100111100101101000010011111010000101011000010001001010000101011
1011000110000000101010010011001001110110111010100111100011101010010111011001000001001110001101100110000000110000101011111000000011100111010101101011101100001001011101111010000110111110100011110000110100000111011000110100011011001011110111011100001000111000
0001100110011010101010111011001100110100101010110111100011101000011101011011110001001100001111011010000001101001001011001010011010100111000001001011000000011010011001110010000101011010100010110100000111110111111010111101001001001011100110011110001100111000
1001100110001000101010111011000101110100101010111011000011001000011111011011100001001110001010011110100010110100000001011010011010100111010001001001100100011000010001010110010110010010100010110100100110000110111010110101001001101110100100111100001000101000
1001100110100000101110101101001001100010001010001011110111110010010101111011000000101010001111110111001000101100011001111011001010100111110101111011101100101000000011110000000110110110000011110100110000010111011000010101010001111010110111111100001000101000
1111000110000000101110101011001101110011001000111111000111110000010111111011000000001010011111100111001000100100101001011110000110100111110001110011101100010000010001110000000110110010100010110100100100010101011010010111010001011010110111010101001000101000
0011100000011000101010110011000110110001100010110111110001001000111001111000110001000010000010111011100111011001000011001011110010000011001001001101011110011011111001010110010101011010100010011110000001000000111010110000101011001110011100111010001100100000
1011100000111011101010110101000010111101111011100111110001101010111000111000110001000010001011010001100111011001100011001011101010000110001101101011011000001011011011010011000001111100100011011110100101001111001000111000111011101110010100101010001100110001
1011100010100011011010111111001001111011111011100111110001101010010001111001110001101000001111100111000000111000101011011010001010100110011100101011111100001001011011110011000010111100100001010100100100101111010000110101011011101010010110111100001000111000
1011000110111011010110111011001000001100001001110010110000010000111001111001100001111011111111000011000000111000101011101011101000100110100100101011011000010001011001110011000001011000100011010010100110011111001010011101000000101010000111111111001100110111
1001000101000000011110001011011011110010100110111010000011111010110011011001010000100101101101100110000000010000001000111001000011100011010100001000100110001000011011110010000110011010100101111000110100100000000010010001011000100011100110111000011000101000
0100100010000101001110001100100101100000101011011101001001011010010111010011010110101100101000100010001000100100110101101110110111001111101000100010001101101110000101110001100000110001011000000001011110100101111000000111010011010101000010000100010010101000
0011011011000001001111000100110100010001100011011111110101011111010010101100011000101010100100000000100000110001110000001011100101001011001000100000001001101010100110101000011001110001001100001011011111001001000110010100001000000111000010100110010011011101
1000010000111011001000001101010010101100110010000101000100001101011110000000111010111100001000001000100110100010000010101011010010100000001100011101010000011100111000000110010011001001101011101010110110111001110010101001101001110111000101101010001101010011
1000010000111011000000001100100000101000010000000101000100000001111110000000100000111100001000001000001100100000000011101011011010100000011100011000010001001100010010000010110011001101001011111010110100111111110000101001110001110111000101101010001101010011
0011011111111000011101001011011100010000000111111011110001010100011010101000101001001110111111000001010001110001101000000000101100101011000000111011001100011010011101100000000111110011100100001110011010001010000010011101001000001011000010111110011100001100
0011110100011000001101001011001100010010001101111011100001110100011010001010101101001110101111000101010001001100101011001010001100100111100000101011001100010010011101110000000111110010100100001110001000001110000010011101001010101010000110011110011100101100
0011000010000000101110000011000100110011101011111111100101111010011111111010110111001110001011000111000001101001101011001110001110100111100001111011001100001011011101110000000110110000100000001010101111010111011000010100001001101010110010111110011100111000
0011000010010001001110001011000100110011101011111111100101111110011110111110111110001110101011000101000001100001101011001110001110100111100001110011001100011010011101111000000110110000100010101010101110010111011000010100001000101010000010111110011100111000
1011100100000000101000111111001001110111011000000011110011100010100001111011100001000010001011101111000101111000100011010010100010000111010101001011110110000001011011010011000100011110100001010000100100010100001000110001111011001010000100011000001000110000
0011000110011010011101101011001100011000001101111010000111110000001010011110110110001010101111000011000001011100101000001000001100100110100000101011001000010011011000110000000111110010100100110110101010000110000010011101001010111010100010011110011100110001
0111101111001100011100111010111101110000101011111111111001011100010001111111010001000010100111100111001001011101101111111010100110011111010000100011101101110001001001110011000100100010011100000001001101100001001110000111010001001000010010010100001010101001
1011100000000000111010011001001011110110111010000111000011101010110111011001010001101100001001111110101010110100000011111011000011100111010101001001110100101101001011010010000110011100000001110000110100100101011000110101111001100011100000111000001000100000
1011100110111010011000110011001001111110011010110111110011100000011101111001110001001010001111100111000001111001101001101010001010100110010101101011111010011000011001110010000110111010100011010000100101001111011000111001111001011010110110111100001100101000
0001010010010000001000111011000100111001001010111111000101000000000110011101010000001010001110001001100000111100011000000010001110101110000000010001000010101010001001011110010011010011100000110100110100010110110010111101001011111010100011101100001100101001
1000100000111011110010110100110010101100010000000000001000000001111100000000100011110000000010011000100110111010000110101011110010010000001100001100010000011101110010000111011001001101100011011010100010101000111100101100110001110110000100101010001101000011
1000011011011011001000110010110000101000000010110101000000001101101000000000111011110000000100011000100110110010001110101110000001010000010000001000010001011001111000000111011001001001101110101011001010111000100110101000101010110001000100100010010111000011
0000011000011011001000010010110100101000000010100000010000000101101000000000111011110000000100011000100110110010001010101111100111001000000000000000010011011111001000000101111001001001001110001011011110111000100110101000100010110111000000100110010111000001
1000110000111011111000110100110001101100110010000000010000001101000000000000011001111000000000111000101110010000000111111011110001001000011101000000110011111101000010000111111001001101001011000011110000101000101100101000110011100111000100100100000101000001
1011101010000000001000100111001001110010111001101111001011101010000001011011010001000000000111110110001001011101101011111010100011010111011100101010101100101001111011110011001100110110000001010001000000100100001100110010011011000001010110010100001010100000
1011101110000000001000110011001001110010101011111111110011100000000001111011010001000000000111110111000001011001101011111011100011000111010100101011101100001001111001110011001100110010100000010000000001100000001110110010011011001000000110010100001010100000
1011101110001000011000110011001101110001101001111111110011000000001001111011110001000010000111110111000001011001101011111011100010000111010000101011101100011001111101110011001100010010100000011000000011100100001110110000001011001010010110111100001010100000
1011100110000000001000111011001001110011001011111011110011100010000001111011010001000010001111110111000001111101101011011011100010000111010100101011101100001001011111110011000100111010100000010000000101010100001010110001011011000010010110111100001000111000
0010010000111011001100111111000000101000100001100001000100011100001110000000111110101110101111100000100000110000101001101111100110001000111000100001001000011001011011100000000011011001101100101010101110001000000010011101001000100010000100101010011001010001
1010101010011011101010110100100001101101010010000101011001000001010101010001110001111000000010111111101110111100000111111010100011010010011101001000110001111101010011001111111000011101001011010001100110100100111100101010110001100100000101000100001011011001
1111101010000001001000110111001001110011111011100111011001001010000101011011010001001000000111100111001001111100101011110000100010010111011100101011101100101001011011111011001100011110100001110000000100100100001100110110011001000000010110000100001010111000
1011101010001100011000110111001001110011101011110111010011000000000101111011010001000000000111100111000001111101101011110000100010000111011100101011101100011001011011110011001100011010100010010000000101100100001110110100011001000010000110011100001010111000
1011101110011000001000110011001001110001001011110111110001000000001101111111110001000010000111100111000001111001101011101010100010000111010000101011101100011001011001111011000100011010100010010000000101100100001010110100001001001010000110111100001000110001
1111101010000000001000110111001001110011111011100111010011000010000001111011010001100000000101100110000001111100101011110000100011000111011100101010111100000001011011110011001100011110100001010001000001100100001100110100011011000011000110000100001010111000
1101001010000100101010000001000100110011011000011010101001100010000111111111000000000010000010010111001000001101010001010000011010110111100101111011001100100010000101111010000110110001110001010000000011000110110100110110010001011100110010011101001110101000
1000111100100000100100000000001010000110101000011011100011101011100000100100100001001100011000010100011111100001010001001011011001101011100101010110011101101110100101001000100110110010011011110111010001101110101000100100110111011111110001111010100101000100
0001110110100100111101001000101100100110000010001010100011110011100111101000010000000111001000010100001001000001010101110101010101001011100001000110101111101110100101100000100100100110000010111111110001001000111000100001010011110111111010110101100101000000
0100100101000000100010001001001110010110011000101000101000110110001010111011101011000111110010011111010010000111010101000100011100111101000001100111000110000010000100010110000010110000110100100100101101010110001000110011000010011100111001111011001100100100
0101101101000000100001001001011110010110101100011010110010111110000000011011000001000101111000010110010001001111010010010000010101101111000001111011001110000010000100110010001100110110100100110110001101110011011000110011001110011111110011111010000100101100
0001011111000000111101000001101100010110000010101010000011110111100010001100011110000101110001010010010000100001010001100111001101101011100001100110001111101010100101100000001010110010000100101101011101110010000100010000001110010011110010110110110111000100
0010111101100100000111000101011110000110011101001000101110111111100010100010001110000111100000010100011011000111110100111101011101111101101000100110001111100110100110000000100110110110011100100111011001111110001000010000100100011111111001100010110001100110
0001011101000000100000000000111100010110010000011010100111100111101000101000001010000100000000011100100011000011010000000000011101111001101001000000000101100010000100000000011110100010000100101111011001111010100100110000001001011111110000010010000111000000
1010110100101000000100010010101001000110000100111000100010110001000011100000000111110110100101100101101001010001101010110100100101011001110000100000101101110101001100100100111100000000001010011011110011001100001110000000010000100011000110010000010001000000
0010111100011000000100001010001100011100010001111000110110010000001000000010001000000000000101110000000001011001111000000100001101101000100000100010001001110010001110100000000111100010001000000011011011101000000010001000001000001001100010000010000111100001
