0001011110000000101100000001001100110000101010001010110011111110000100101110001000000100101000010000001000100101010001100111000111001111100001000010001111101010000101110100110001110000001100001011011101100100010000010000001010010111110010100111000101101000
1001100100100000101000010001000110010110010010100010100000100010111010101000110001001101011001011100010101100001010011111011010011100011000101001111010100001011110101010010000110101000100101011010110101111011100000110000101111001111010010111010101100010000
0101000000000100101000001011001110110010101010111010100001100010101101111001110000000110000011010111000001000001010001011000111010100111000001011111001110000010110101110110000110110001110000011000100101000110010000110001001111011010000010011011101000100000
1011101000011110110001111011001011011111111000110010000011111000101111011111100111000101111111010111110011011000101010010001001100110100010101101101100110010001111000010010000110011110110100101100001110110010001000011001101110101010111101011011111110110110
1011100100011110010001111011001011011101011000100010001011110000100111011011000101000001011111110111110011011000101110010001001000110110010101001101101010110001111000110110010110011110110100011000000000100010001010011010011111101000101101111001101110110111
1011101100011110110001111011001011011111111000100010001111111000101111011011000101000001011111110111110011011000101110010001001100110110010001001101100010010001111000110010000110011110110000111100000100100010001010011000101110001000101101011001111110110110
0010011011000001101111000000110100100000100111001101111001111111010001100111011010101100100000000010001011100001110101101111100101011010100001110110000001101110100111101000101001100101001100001001011101100001000100000110000000010101011010100100010011000001
0100000011000001111110000100110100100010101011011101101100011111010011010011010110001100100000010010001010100111010101101110110111111111101001100010001101101110000101110100101010100001001100000001011011100111101100000110110000010101011000000100010011101000
0011001010000001101110000000000100110010001010001111100101111010010001011011010000001100101001000110001001100101110001111010011111101111100001100010101101101010000101111000001110110100001100100001001100100111010100010110010011011101110010110100000110111000
1011000110000000101010000001001001110110011010001011100011101010010101011001010001001100001001100110000001100001110011111011001011100111010101101011101100001000010101111010001110111110100001111101110011000110011000110100011001001011110110111100001000111000
0001101110010000101010111011001100110110111010111111110011101000011101111000110001001100001111011110000001101001001011000010001010100111000001001011000100011011011101110010000110011010100000111110000111100111111010110101001011001011110010111110001000101000
0011100000111001111010010011000110110001100011110111110001001000111101111100110001001010000110011001100011011001001011001011110010100010000000001101011000011011111101010111010001011000100000011110100011001000101010111000001011101110000000111010001100000001
1011100110000001001010111011001001110011101011111011000001101010011011011001110001101100001111100111000000110000101011011011000010100111010100101011101100001001011011110010000010111000100001010000100100110101010010110101011011100010010110111100001000110000
0011100110011001001000111011001101110000101010111111000001101000011111011011110001101100001111100010000000110000101011101010100010000111010000111011001100011001011101110010000101011010100000110000100110010101011010110101001011000010000110111100001000111001
1001101001000000011000110011010000110011100011110111110001111100001000111110111001000010000111111011000001011001001111001011100010010011000100101111110110001001111001100010001100001011110100001110001011000001001100110000101011001000001110110010101010010000
1001101001100010011000110011010010110011100011110111110001001100101000101100111001000010000111111001000001011001001011001011100010010011000100001111010100011001111001100010001100001011100101001110001001001010101110111000001011001010001110111010101010010000
0011100110011011001000111011001100111000101010110111000001101000011100011000110101011110001111000011000001111101101010101010100010000110000000111011001000011011011000010011000001011000100010011010100110010001011010111101001101100010000111011110001100111001
0011100110111000001101001011001100010000001101111110110001111000001010001010100101000110101111000101000001100001101011000011100100100111100000111011001110011011011101110000000111110010100100011110001100001110001010010001001000101010010110111110011000101001
1011100100000000110000111111000001010111011000100111110011100010000001111011110001000010001011111111000101111000000011010010100010000111010101101011110110001001011000011111000100011110110001010000100100010100001000110001111011001010000101011100001000110000
1011000100111011001100101011001000011000001011111011000101110000001011011010100100000010101111000011000001001000101001001010101010100110100000101011001010010000011000110000000111110010100100011110100010001110010010011001001010111010110110111010011100100001
1011101000000000011000100111001001110011111011101011110011101010010001111011000001001000000101110111001001101101101011111011100011000111011101101011101100101001011011110011000100110110100001010000000101100100001000110000011001000010010110110000001000100000
1011101100000000011000110011001001110011101001111111110011101010000001111011010001001010001101110111000001111001101011111010100010000111010100101011101100000001011101110011000100111010100000011000000101100100001010110000011011001011010110111000001000110000
0011101100001000001000110011001101110001101011111111110011001000001001111011110001001010001101110111000001111001101011001011100000000111010000101011101100011001011101110011000101010010100000011000000011000100001010110000001001001010000110011000001000100000
1101000010000000001010101101000001010011111010000011010011100010010001111011000000101010001111100111001001101100001001010010100000000111011100011001110100101000011011110011000100011110100011010000000000000100000000010101011001000010000110001100001000101000
1101000110000000001010101111000001010011001010110011010011001010010001111111010000001010001110100111000001101100001000011000100000000111010100011001110100001000011011010001000100011010100001010000000000000100000010010101011000000010000110011100001000101000
0100000110000101100110000000101101100000001100011000001100100010000101010011000110010001001000100110001001100100010101100100010111001101110000110011001111100110000101110000100100110010011010110101000100100100111010000111010010011101010011010101010010101010
0101011010000101101101000001000100110011011110011111101001110010000110101110001110000110100010010111000000001001010000010100011100111111100001110011001100000010000101111000000110110000100000101011011001000110111000010100001000010110010011010110010110101000
0000010100100000100100000000101110000110101000011001100111111011100111101101000100001001011000010000011010000101010001001111011111101111100101010110001101100110000101101000101110110010001001100101010001101110101100000110010111011111110010110000110101001100
0100010111100000101101000000111100000110000110011100001110110111101010100100011010000000110000010100010000000011010100000110011101111000100001100010001111001110000100000000001110100010001100101111011001101010000100000010000110111101110010010111110111000010
0001110100100000111101001000101110100110000110001010100011110011100111001000010000010111100000010100000001000001010001110001010111111011100001100110001111101110100101100000101110100110110010111111110101011011111100000001011010111111110010110000110101000000
1100010100101110100100000000111011001101000010010000001110100101100010100100001000110111010000010001010101000000000101010100010001010010110101100110111001110100110101000000101110101010011011101111110100111000001100101000111101111000110100010011100011000111
1001110101100100100001000000101011010000000000011010011000100011100001001100010001100100100000110000011001000011010110100001110001010011010101001110111001101101100100100010101001100000010101011001110001111000101100100000011001100111011111110000100101010111
0010111101000001100100011110111100010110010000100000100000110111001110000010001111000110000101000100100010010111001110010100001101111000101001100000001101000011001110000000001010001100001100101111011011000010001100001011101001000001100000000010010011011000
0010111101101001000100010100111100010110010000000000100000100101001010000010001111010110000101000100100100010011101110010100001101111000100000100000001101010111001110100000101110001100001110101111011011001010001100001010101001100001100000010010010011010000
0010110101111010000100000010101101001100010100111000100010010000000010100000001110000110100101100100101001010001111000100100100101101000110000100000101001110110001110100000101111100010001000001011110011001000001110001000000000101001000010000000000001000001
0010110100011000000100000010001100011100010001111000010110010000001000000011001000100100000101110010000001010001111000100100000101001100100000100011001001010010001110100000001001100010001000000011011001110000000010001000001000001001000010000010000000100001
