0001011111000000011100000001001100110000001010011010100011110110000100101110011000001101101000000000001000000101010011000011000111101111100000100010001111101010000101100000101010110011001100101111011001101010011100010000001011001111000010110110000011101000
0001100100000000100000001001001110110110011000001010100000100010001111111001100001010101011000011110000100100001010011010001011010100111000101001011010110000010010101010010000110110000100011110100110101110111111000110001011011010111110011111001001000100000
0001110100100000100000010011011110010010000000100010100001100010111000101000110001001101010001011100010001100001010011011011011001100011000101011111010100001011110101010010000110011110100101111010010101101011100000110000101111001111010010111010101000010100
0001000100000000100000001011001110110010101000111010100001101010101011111000100001000111000011010110000000000001010001010001001010100011000001101011001110000010010100110010000110110010100000011000100001000110010000110001001111001011010011111011101100100010
1001110101100000101001010011011010010110100010100011100111110110111010101000111001000100011001011100110001010001000011011011001001100011000001001101000100001011111101001010000110001010100100101010011001001011000000110000001100001011110100111010101100010100
1011110100100000101001010011011010010110110010110111100111111110111010101000111001000100010001011100110001010001001010011011001001100011000001001100000100001011111100100010000110001010100100001011011001001011001000110000001100001011101110111010101100010100
1111100100001110110001111011001010000110001000100010100011110010001011011011100001000111111011010111111001011100000011010000001000100111000101011101011110000001111001110010000110011110110001110000100000000110000000111011110111101000111100011001101100110100
1011100100011010110001111011001011011111011000100010001011110000000011011011100001000001011111110111111011011000101110010000001000100110010101101101101010110001101000110010100110011110010001110100100000100110000000111011111110101000101100011001101100110110
1011100100011010110001111011001011011111111000100010001111110000101011011011000101000001011111000111110011011100101010010001001100110110010001101111101110010001111000110010000110011110110100110100101000000010000000111011111110101000111101110001101110110110
0010001011000001101110000100110100110010101010001101101101111111010011111011011100001100100000010010001011100101010101001110011111111111101001100010001101101110000101111000101110110101001100000001011111100011001100000110010000011101011010110100010111111000
1010010111101010001111000011001000001000100001110101100100111000111000100000110100001010100101000000000100100000101001011011000000100010110100101011011000011100011001111000100010111000100001010110110100001101000010011100010010101010011111111110011000000110
1011100010000000101010000001001001110110111010001111100011101010010101111011010001001100000001110110001001000001110011111011011011100111010101101010101100101000000101111110001110110110000001111101010011010110011100110000011001001011110010110100001100101000
0011001110000000101010001011001101110110111010101111100111101010011111011011010001001000001001000110000001100001110011011011011111100111000001101011101100001010000101111010000110110010100000111100000111100111011000110100001011001011110010110100001010111000
1011100110000000101010010001001001110110111010000111110011100010010101111001000001001110001001110110000001010001110011111011011011100011010101101010111100001001010101111010001100111110100001111101110001110110011000110000011001001011110110110100001000111000
0011100110011001101010011011001101110000101010111111000001101000011111011011110001101100001111110010000000110100001011101011100110000111010000101011001100011011011101110011000001010010100000111000110110000101010010110101001011000011010010111110001000111001
0011100000111010101000011011000110110001100011110111110001001000111000111000110001001110001001010000100011110001100011001011100010000010000001101101011000011011111101011110010001011000100000011010110101001001001010111001101011100111010100111010001100010001
1011100010100001011000111011001001111010101011111111000001101010010011011001110001101000001111100110000000110000101011011011000010100111010100101011101100001001011011110010000010111000100000010000110100111101000010110101011011100010110110111100001000110000
1001100001101010011000010011011010110011100011110111110001111100111000101100111001001010100111011101000001011000001011001011101010100011000000001111000100011001111001100010000100001011100100001110101001001011001010111000001001101010000110111010101000010000
1011100000111010001000110011010010110001100010110111110001001100111010101000111001000110001111011001100001010000001011001011100010100010000100001101010000011001111001000110010111001001100101011110101000001011101010111000101001100010000100111010001100010000
1011101001111010011000110011011010110011100011110111110001111100111000101100111001000010100111000101000001011001101011011011101110110011000000101111000100011001111001100011000100001001100100001110101001001011001010111000001001101010000110111010101001010000
0011000111111011011101101011001100011000101011111011110001110100001000101000111001101110111101000000010001100001101001000010100100001010100000101011001000011010011001110000000001110000100100001110001110001000001010011001001000101011010010111110011100101101
1001100000000000101000110101000001110111011000000010110011100010000001111011000001000011001011111111000111011101010011011010100010000111011101101011110110001001010011011111010100011111100011010100100001010100001000110000111001001110010100011000001000111000
1011000110111011001101101011001000010000101111111011110101110000001000011000110100100110101111000001010001000000101011000000100000000110100000101011001010011000011001110000000001110000100100010110101010001100000010011001001000101010010110111110001100101001
1011100100001010001000111011001000011000001001110010110001100000001011011011100101000110011111010111000001011100101001000010101000100110010100101011011110011000011001110010000110111010100010010100100000000110001010111001001011101010110110111000001000100000
1011000101111011010101101011001000011001001101111010010101110000001001011010100110100111101111000011000001001000101000000010101000000110100000101111001010011000111000110000000001110000100100011100101010001000000010011001001010111010010110111000111100100001
0011000101011011011101101011001100011001001111111010010100010100001000011000101110100010101111010011000000001010101000001111001100100100100000101011001010010010011000110001000001110000100100001110101110000000000010011001001010111010000010111011111100100001
0000011100100000100110000000101110100110100000011001100011111011000110100100101111001001111000010000011110000101010011001111011011101011100101110110011101101110100101101000101110110010011001100111011001101110101100000100100111011111110010110010110101000100
0000111100100100100100000001001110000110100010011101100111111011001110100100001100001000011000010000010110000001010001000100011111101011100001110110011110001111100101000000100110110010011010100111010001101110101000000100100111011111110000010010100101011100
0100011111000000101101000000111100000110000110111100001110110111101010000100011110000001110000010000010000000011010100000110011101111000100001100010001101001010000100100000001110100010001100101111011001101010100100001010000100011101110010010111010111000110
0100000101000000100000001001011100010110001000111000101110110110001010100011001010000110100000011100000000000111010101000100011100111101100001000011001100000010000100000000000010100000101100100010111001010010101000110011001000011100110010011010010110101000
