0000011101000000100111000000111110000110000110001000001110111111100010100110011110010101100000010000011000000011010100010100011101111001100001100110001101101110100100100100101010100100001100100111011011111010100100000010000100010101111010110000010011000010
0101000000000100000000001001000110010010001010000010100001000010001001111011100000000101001010000110000001100001010000010000000000100101000100000001000110000010010100010000000110010000100001110000100101100111000000010001011010001011100000001001101100100000
1001000010000000000000000000100001010010101010000111110011001010000001111101010000001000000000100110001001100001010000111011001001100101010100000000100101101000100100011000101110010000000001111101110001000110000100010000010000001011100100100100001000101000
0011100000111010011000010011000110110000100011110111110001001000111101111000110001001000001101010000100010010001101011001011000011000010000000101101011000011011111001011111010001011000100000011110110001001000001010111001001001100111010100111010001100010001
1001100110001011001010111011001001110000001010111111000001101000011011011001110001101000001111001111000000110000001011001010000010100111010000001011000100011001011001110010000011011000100000110100100110110101100010110101001011100010100110011100001000111001
0001100110011011011010111011001100110000101010110111000001001000011010011010110001001100001111001010100000110000001011101010100010000110000000001001000000011011011001010110010011011000100000111010100110010101110010111101001011000010000010111110001100111001
1001100101101010011000011011011010110000100011110111110001111100111010101100111001001110001101010000000001110001101011001011100010000011000100101111010100011001111101100010000100001001100100001010011001001001001010111001101001000011000110111010101000010000
1001110101101010011000011011010010110000100011110111110001101100111000001100111001001110001101011000000001010001001011001011100010000010000100001111010000011001111101100010000000001001100101001010111011001001101010111001001001100011000110111010101000010000
1011100101111010011000011011010010110000100010110111110011001100111000001000110001001110001101011000100001010001001011001011100010000010000100001101010000011001111001101110010001001001100101011010110001001000101010111001001001100011000110111010101000010000
1011100101001000011000011011011010010001100011110111110001111100111000101100111001101110111111010000000001110001101011001011100000000011000000101111000100011011111101100010000100001000100100001010111100001011000010111001101010001011010100101010101000010000
1101100010000000101000110101000001110111011010000010110011100010010101111001100001000010000011111111000111011001010011011000100010000111011101011011110100000001010001010111010100011111100011010100100001010100011000110000111001001010010100011000001000110000
1011100010000000101000110111000001110111011000100110110011100010010101111011110001000010001011101111000001011101000011011000100010000111011101101011110110001001110101010111010100011111100011010100100001010110011000110001111011001010010100011100001000110000
1011100010011011001010101111001000111000001001100010110001101000011001011010100101101110001111110111000101001100101001010011101000100110001100101011111000010001011011110010000000111100100011010110100000000100001010111001101001101010010110001010001000100001
1011000110111011001101101011001100011001001111111111000101110000001001011001110100101110111111010011010001100000101001001010100000000110100000111011001000011000011001110001000001110000100000110000100010000100000010011001001000110010010110011100011100100101
0011000110011011000101101011001100011001001011111110010101110000001001011001110100100110101111000011000001100000101000001010100000000110100000101011001000011010111000110001000001110000100100010000100010000000000010011001001110110010010110111100011100100001
0100010110100000100100000000111110100110011100001100000010100011000111000001010010010100001000001100001111000110010100011100011111101101100001000010010101100110000100000000101110100110001010100101110000101110110000100010110001101101110001010001010101101010
