0110010011000101001111001000110100001110001111111101101010011111010011010011011010100110110001000010011001100110110100001100100101101100100000110010001101100011000100110000101010100000011100000001111110010011000000000111000000101000001010010101110101111100
0011000100010010000101101001001110011101101110000010010001111000110101011001000100100101101111110011001011110000101000101011100101000110110000111011101010101100001011111010000001110100100000010100100100100101010000011000110000011011011001101000011100100101
1111100100110010110101100011001010011000001101111011000010110000100001011001100110010001100011010000001001001110111000001110111000100100110101101111001010010000010000110000000001110000110010010000110000001100001010011000010000111010010111011000011100100110
1010100101010010110101100010101011001000001101111000011110110000101001010011100110110001110011000010000000000110101101001111011001000100110101100111001010010001010001110001000001110000100000010000110000000100001010011010010000111000011111111000011100110010
0101000111000100110111100010011111010010001010111010001111110110010001011011000100101111110001010010011001000111111000100000110101000111110001100010001111000000000000110001001001100000010100000001001011010001000110000010011100010001011110010101111100101110
1001000101011000100011010010011000010000000000110010000010101000000000001000000001010001010101011100110100010010001010010000010000000010000101011000010000010000011010000010000000001001000011010000000000000000110010100000101101000100010101010000100000000111
1111100101000110110011010011011011011110111100100010000010101010101101011001100001110001010001011010110110010110100110001000000000000110011101001101010000000001010000010010010001001100110011010000100000010000000000101100110101100000010111001001101100110110
0011001100001000011100100010111110010000100011111111001011011101111011011000111000101100110111000011000000010001101101101011000111010011100000101111001100011011111101101011001101100010100100101100001000100001000110000010001000000000111010111010101110110000
0111000100011111000100101011001110111001001101111010010000010000101100011100100110110010101111000011000000011000101001000100100110000100110000110011001000010011011001110001000001110000110010010010100010010100011010011101001000110010010111011011011100110011
1111000100011111000110101011001000111000001001111010010000000000001101011000100110110010001111100011000000000000101001000100100010000000110000111011001000010000011001110001000001100000100010010010100000010100011010011101001000110010010111011011011100100011
0000001001000101100101000100100110010110011100101000111100110110000001111111010110000000110000110110011010000111010110010100001101111101101001000100000101101010000110010001001100010101011100000001001001010110110100010010000100011001001011000000011010110100
0001001000010000100100000000100101000100010100111000110100110011000101111011000110010000100000000011000001001011010100000101001101110001101001100010000100010000000000110100001111110010100010011001000001110110100100000010000000011101000110010000011110000000
