1001111001110110111110100010111000011111110010111010111111111111001000100110111001000010010011000001010001001011010111000001001000110010101101101110011010001011110001100101010001000001110101001011000011001010100100001001001001001000000110111010100111010100
0111000110011011000100101011001110111001001101111010010100010000101100011100100110110010101111000011000000011000101001000100100110000100110000101011001010010000011001110001000001110000100010010010100010000100011010011001001010010010011111011011011100100011
1011000100011011000110101011001011111000001001111010010100000000001101011100100100110011001111100011000000000010101001000100100010000100110000101011001000010000011011110001000001101000100010010000100000000100010010011001001000110010011111011011011000100011
0011011000011111001100110111000001111001001001000010010101000000010100101111011000100000011101100000101010011000101001100000100101001110111000010000101000110101001011010101110001010101010010011001010011000100010010111001101001000010000000000000000000110001
1100000100011111000100101011001010101001000001111000011000000000001101010100100100110011001110000011000100001000101001100100100010010010110100100011011010010000011001110001000001100000100010010010100100001100011010001011000011110000010111011011001100001001
