0100011101000100110111000000111110000110110100001000101110111111100011100111001110010111100000011100011010000111010100110100011101111001100001000010100111100110000100000100101110100010011100100101011001000110100100000010010100010101111001010001110011000110
1001000110010110111000111011000001110111001000111111001111100000001111011011100100010010001010101011101001001100011000000010111010100111010001001001000110011000110001010111010111010011110010010100100110010110110010110011011011011000000111011101001100101000
0101001110000100100111101010111111010001001010111010001111110010010001011011000100101101110001100010011000000101111000000000110101000111110001100010001011100000000000111001001001100000000100010001001001110001000110000011010100010001011010010001111110101100
0101001110010100110101100010011100010000001100111010011111110100011001011011010100100101110001000010010000001101011100100000010101001111100001100110001010010010100000111001001001100000110100001001001011110001100110010110001100010001011010010101111110101110
1101100110000000001000010111000001110110111011100111101010000010111111011001110111001110001101111111000001110010101100011110011010100101010100011011100100001000011000011010000110001110100000110100101100000011111000110110011000011000111110011100001000101000
0111100110000000111000101000111100100111001010111111101111100110001010111011110000000010000010000011000100001100010001000010011010100111000101111011011110001011010101100110000110110010101101100110101100010010010000100011000011110100100010011111001111101000
1101000100011100100000111011000011010100001000111010000111100000001110011011100000000111011010111010110100010101000001100000010010000111010101010101010110010100110001110101110101010010110011110100000100000101110000110001011111010110011111011011101100101110
1101000100001100100011111011001011010011001000110010001011101000011101011011100001000111011110111111010110001010001110010000011000110111010101101111110110010000011010010011000110001011110011010000100000000001111010110001111101100100001101011001101000100111
0011001101001000011100101010111101010000100011111111001111011101111011011001110000101000110111100011000000010000101101101011000101010011110000101111001100011000111101101011001001100010100100101101001000100001001110000010001000000000111110110000101010000100
