1000000000001110000000001010100001000000000010011000000100001001000010000100100100000000010010100100110001001000000100010000000000100000010000010100001000110000000000000000100110000000100000011000000000100000000010000001000100000100000010010000000001000100
0101100010000001100001000101000101000010001000001010000001110010110001011001000000101001100000101110001000100100010001110000110001000111011101110011101100100101000101110100100000110100000001010000100000010101111000110110010000010110010011011101001000101010
0100011101000100110111000000111110000110110100001000101110111111100001100111001110010111110000011110011001000111010100110100011101111101100001000010100111100110000100000000101110100110011100100101011001000010100100000010000100011101111001010001110011001110
1100011110000000100100000000101001000110011000011101101110110011000111100111010110011010110000101110011100101101010100110110001001111101110101110010110101101100000001101101111100110011001011110101010001110110110100100110010000010101000111010101010011001100
1101001011000100010101001110101001010011011001011110001111010010000011011011000100001000111100100110011000100100111100110100000100001111010000100010101111100000000110110001000110110010011100110001001100110101100110000111010110010001110110010101111010111110
0001000010011010101000111011000100110101101110110111000111101000001101011011110100010010000010001011100111001100000000000111111110100100000001010001000010011010000000010101010011010001100010010100100100010110110010111001101011011110000001111100001100110000
1101100000000100110000111101000011100111111000000010010011100010000101011001000001110011000011110110001110011000010011010000000010000111011101101011110110100100010011010111110100011111110011110100100100000100110000110001110011000110101101001000001000100000
1101000111000100110111100010111111010000001010111010001111110010010001011001000100101101110001110010011001000111111000000000100101000111110001100010001111100000000000111001001001100000010100010001011001110000000110000011010100010001011110010001111100101100
1101100110000000001000011111000001110110111011100111101010001010011111011011110111011100001111111111000001100010001100011110011010100101011000011001100100001000111001011010000110001010100010111100100100010011111000110110001001011000111110011100001000100000
0011001100011000011101101011011110010000100011111111000011011100111010011010111000000100100111000010000000000001101101101011000100011011100000101111001000011011110101101011001001100010100100101110001010000011000110011001001000000000111010111010101110110001
1011001101000000011101100010111011010010100011111111001011111101111011011000110000101000110111100111000000110000101101101011000101010011010000101110101101011000111001101011001100100010100100101101001000100001000110000010001000000000111110110000101011000100
0011001101011000011100100010111110010000100011111111000011011101111011011000111000001100100111000011000000000001101101101011000101010011100001101110001100011010111001101011001101100010100100101101001000100001000110000000001000000000111110110010101110000000
1101100011000100001001110100110001010110011010000111001010100010010001011011010001000000001001101110101110110110000110110010000001100111011100011000110101101101011010010010000100011111010101010001100100110100011100100110110011000101001101000100001010111000
1101101010000000001011111111010001010110010010100111101001000010000001011111110001001000010111101110110001011011001110010010100000010011011100011001110100001001011110010110011100001111100001111001000001110001101100110111111001001000001101010100001010111110
1101101011000000001001111110110001010110011110000111001010001110000011011111010001001100101111101110100101010110001110110010000000010111011100001000110101001001011110010011001110001111010101010001000000110000111100100110111010000001101101000100001010111100
0111000110011011000100101011001100111001001101111010011000000000001101011100100110111011001111000011000000000010101001000100100010000100110000111011001000010000011000110001000001100000100010011000100000000100010010011001001000110010000111011111011100100011
