1101100010100001100011000101000001000110011000001010000001110010110001111101000001100011110000100111001000000000010001011010110000000111011101110011101100100100000011110010100000110101000011010000110100011101110000110100010000110110010011011101001000100110
0100011101000100110111000000111111000110010100001000101110111111100011100111001110010111110000011100011011000111010100110100011101111001100001000010100111100110000100000000101110100110011100100101011001010110100100000010010110011101111001010001110011000110
0100011111000000100111000000111110000110001100001000001110110111000111110111000110010011110000011011011000000110010100000100011101011101100001010000000111100110000100100100111010100100011110100101011000010110110100000010010110011100101011010001110111101010
0100011100000100100011000000111110000110010100001000101100100111010100100110001110011011000000011100111111001111010100110000110001011001100101010110010101100110100100000001100100100100011011001011010001011011110100000110100100010101011001010010110111001110
1000011110000000100100000000101001000110011000011101101110110011000111100111000010011010110000101110011100101101010100110110011001111101110101010010110101101100000000101101111110110011001001010101010001110111110100100110010000010101100111010101010011001100
1101001111000100110101101110111001010010001100111010001111010110000011011011000110000101111010100110011001100111011100110100110100010101110001000011100111100000010100110001011100110010010100100001001100110101000110000111010000010001100110010101011010101100
0110010011000101001111001010111100011000001111101101101000011111010011010011011110000110110100000000011001100110111100001100101101111100100000110010001111100010000100110000001011100000011100000001111111000011000010000111000100101000001010000101110101101100
1011101100011000110101100011001001110000000000111010110011101000011100111110101101010011000011110011000101001001101101101011110000010011100101111111011100011000110101100000001101110010100011011111000011010000011110010010001011001000011111110010001110000100
0011011010000000001000010101010100110100010010000010100001000110001000101010001001000011000111101101110011011001101011110000101110101010001000001001100110001011101111000110010110011111100100001011011101001010001000110000101111001110000000100111100010111001
0001000110011010101000111011000100110101001100111111000111001000001111011011110100010010000010001011100011001100010000000011111110100101000001001101000110011000110000010101010111010011110010110100100100010110110010111101001011011110100101111100001100110000
1110100101010010110111100011001110001001001100111000010110110000001001110111100110100011111111000011000000100110111101001110001001000110100001100011001010010000010000110001000011110000110000010100100110000100001010011010000000001000110111011000011100101110
0101001110010100110101100010111100010000001110111010011111110100011001011011010100100001110001010010010001001101010000100000110101001111100001100110001110011010100000111001001001100000110100001001001001010001000110010110001100010001011010010101111110101110
1101100111000000001000010111000001110110111011100111101010001010010111011011010111001110001101111111000001110010101100011010011010100101001100011011100100001000111000111010000110011110100100110100101100010011111000110110011001011000111110011100011000100000
1101100110000000001000001111010001110110111011100111101010001110011111011011110111011100001111111110000001100110001100011110011010100101011000011001100100001001111100011010000110001010100010101100101100010011111010110110001001011001111110011100001010100000
1101101111000100111000101011001000110111001110111110011010100010000001111011110011110010100010001011000001101110010000100000110010000101000101111011001110000000010000110011000001110000110010010000000110010100111000110011011010010100011111011101001110101000
1101000100001100100100101011001011110000001000111010000111100000001111011011000000010111011010111110010100000100000001110000010010000111110101010101110110010100010001010101010110010010110011110100100000000100110010110011011111010110101111011001101000101100
1011101010000001001010101110000100110011001011101010000001110010010011011011110001000001011011000111001000001100100011110000111010110111001000100011001110001001011001110001000010110100100000010100000100010111001100110011010001001000010110110101001110111000
1101000100001100100011111011001011010001001000110010001011100000011111011011100001000101011110110111010110001000001110010000010000010111010001111111110110010000111010010011000110001111110011010000100000100001110010110011111101100100001101011001101000100111
1101100101000110100011111011011011010111101100010111001010101010111111010011100101010010000011000111010100001010000110011000011000110111010101111111111100000001010000110011000110001011110011110100100000010011100000110111110100100100111111011000101010110011
0011001101001000011101100010111111010000100011111111001111011101111011011001110000101100110111100111000000100000101101101011000101010011110000101111001110011000111101101011001101100010100100101100001000100000000110000010001000000000111110110000111010000100
1100101011000100001011110110110001110110011110100101001010110110000111011011010011000000101111101110101110010110001110110010000001010101011100001001110101001001011010010011001110011111011101100001001000110100011100110110110000000001101101000100011010111000
1111100011011011000001111111000001010001001001100111001001000000111011011111110001101110001111101111110100010010101110111010100000010111011100011101110000011001111010010011000101001111100001010000100000000000011010111101111101100000001101001100001000110111
1111000100011011000110101011001100111000001101111110011000000000101101011100100100110010001111000011000000000010101100100110100010000100110000100011001000010001011000110001000001100000100010010010100010000101011010011001001010010010010111011111011100100011
0100000010110111001110101010101100101001001110111001001000010000001111111011110110110010100110000011001000001100001101100100110110011100100000000001001000100010000011110001000001110001110000000000101010000100111010001111000000110000000010011101011100101001
1100111110011011101000100000101001001001001011010010011001100001000001001011000000110001010010100001001100101100000001100000110000010110110101110010011001110100000001011001101001111000011011010001000010001100001110101011110011110000010101010001000111101001
