0111100010000101101100001101000101110110011010001010001001000010010011011011000100101000011000100110011000100101010001010000000111001111111001010001101100100011000100111101010100110000010100000001011100000101101000110111001001010101000011010101000010111000
0100011111000000100111000000111110000110001100001000001100110111000111110111000110110011100000001010011000000111010100010100000101011101100001010000100111100110000100110000111010100100011110100101011001010100110100000010010110010100011011010001110111101010
0100011111000100110111000000111111000110010100001000101110111111000011100111001110010111110000011110111001000111010100110100011101111101110001000000100111100110000100000000111110100110011100100101011001010110100100000010010110011101111011010001110011001110
1101000111000100010101101110101001010011001101011110001111010010000011011011000000000101111111100110011000100101011100110100010101001111110000100011101111100000000110110001000100110010011100110001001100110101000110000111010110010001100110010101111010111100
0110010011010100001111001010110100011000001111111101001000111111010011010011001110000110110001000010011000100110110100001100001101101100100000110010001111100011000000110000001011100000011100000101111110000011001000000111000000101000001010010101110101111110
1101100100000001100000010000100011100111011000001010000010100010100111011001000001010101001000111110101111000100010101111000110011100111010101011000110111100101000111011110111110010111000011110101110000000100111000110010110111001111101101010001001000101010
1101000110000100101111100010111111010000001010111010001111110010010001011011000100100100110001010010011001000101110000100000110101000111110001100010001111100000000000110001001001100000000100010001001001110000000110000010010100010001011110010001101110101100
0101000110010100110101100010111100010000001110111010011111110100011001111011010100100001110001010010010001001101110000100000110101001111100001100110001110010010100000111001001001100001110100001001001001110001000110010110001100010001011010010101111110101110
0101100111000100001010010111000001110110111001100111101010001010011101011011010111001100001101111110000001100010001100011110011010100101011000011111100100000001111100010010000110011110100010111100101100010111111000110110001001011001111010011100001000100010
1101100110000000001010010110100001110110111101100111001010001010010111111011110011011110001101111111001001110100101100011010001010100101011100011011100100001000111000110000000110001110100010111100101100000011110000100110011000011000101110011100011000100010
1001000100001100100100101011001011110000001000111010000111100000001111011011000000010011011010111110000100000100000001110000010010000111110101010101110110010000010001010101010110010010110011110000100000000100110010110011011111010010100111011011101000101000
0111101010000001001010101110000100110010001011101010001001110010000011011111010001000001010011000111001000001100100011110000111010100111001001100011001110001001011001110001000010110100100000010100000000000111001000110011010001001000010010111101001110111000
1101000100001101100001101011001011010001001000110010001001100000111101011011100001000111011110110111010101001100001110010000010000000111010001111111110110010000011010010010000100011011110010010000100000100001111010110011111101000100011101011001101000100111
1101100011000100101001110100110001010110111010000111001011100010000011011011010001000000001011101110111110010110000110110000000001100111011101111001110111100101011010010111100110011111010101010000100000110100011000100110110001000100101101000100001010111100
1101101011000000001001111110010001010110010010100111101010000010000001011111010001000000001111101110110101010111001110011010100000010011011100011001110100001001011110010111011100001111110101111101000000110000101100100111111011000001001101000100001010111110
1000101011000000001011111110010001110111011110100000001010010110001011010011010011000000101111101110100101010111001110010010000000010101011100001001110101001001011110010011001100011111010101100001001100110000111100010110111010000001101101000100011010111000
0111000100011011000101101011001110111000001101111010010000010000101100011010100110111010101111000011000000011000101000100100100110000100100000010011001000010010011000110001000001110000100010010010100010000100010010011101001010010010001011011011011100100011
1011000100011011000100101011001000111000001101111010011000000000001101011111100100110011001111100011000000000010101100100110100010000100110000111011001000010000011000110001000001100000100010011000100010000100011010011101001001010010000111011010011100100011
