0001010000000000000100000000000011010001000000000101110000000000111010101100000010111000000011000010000000001001100001000000010000000000100000010111110000000000101000001000000010100100000010011000010001000000000000000100001000110000001001011010000000000010
0111101010000101001100100101000101110010001010001110001001000110010001011011001101101000001000100110100000100100010001110000100111001111101000110001101100100011000100110001000100110000010100000001001100000101111100010110001001000100000010000101000010111000
0101100010000001110010000101000101101010011000001010000001110010110011011001000000101011100000000110001000100100010001011010010000000111111101110010101100100100000011110101100000110100000001010000110010000101111000110100010000110110000011010101001000101010
1101100010000001100010000101000001100010011100001010000001110010010001011001000001101011100001110111001000000100010001011000010010000111011101101011101100100000000011110011000000110100100011010100110000000101110000110100010000110010010011011101001000101010
0100011111000000100111000000111110000110001100001000001100110111000101110111000110110011100000001110011000000111010100010100010101111101100001010000100111100110000100110100111010100000011110100101011000010100110100000010010110011100111011010001110111101010
1100011101000100110111000000111011000110010100001000101110111111000010100111001110010111100000011100011001000111010100110100011101111001100101000010100111100110000100100000101110100110011011100101011101010110110100000010010110011101011011010001110011001110
0100011101000101100110001000111111000000001100011000001100111111000011010011001110100001111010011110111010000110010000010100010100111101110001010000100111100110000000000000101010100000011100100101011000110110100100100011010110011101111001010001110011101110
0100000000110110100011101000100110001101101000001010101100101011110111110011000100010101001010010011111111001110010100000000110000110100100101110111011001100110000000010100110011100100010011010100100000111101011000100110110111111100011001001001100100110111
0101001111000100010101101110111101010111001101111110001111010110000011011011000010001101111101100110011000100101011100110000000101001111110000100011101111100000000010110001000100110010011100100001001100100101000110000111010110010001100110010101111010111100
1101001111000100110101101110111101010010001101111010001111010110000011011011000010000101111001100110011001100111011100110100100100000101110000101011100111100000000100110001000100110011010100100001001101110101100110000111010010010001110110010101111010101110
0110110111110101010111000000110110001000001101111101101101011111100011000001000110000110110000000000011001100110110100001100001101101100100000100010001111100010000000110000101011100000011100000001111110001111001100000111010000101000000010010101110101101110
0110001011010101001101000010111100000011000111111101001000010111011010010010011110000110110000000010010000100111110100100110011101111001101000110110001101001010100100101000001011100000011100101111001100000011001100000111001100011001101010010110010111001100
1011101100011000101100100011001011110000000010111010111011101000001100111110111101010011000011110011000101001001101101101011110010010011100101111111011100011000110101100000000101110010110011011010000001000000011110010010001011011000011111110010001110000000
0001000110011110101000111011000100110101101000110111000111001000001101011111100100010010000010001011100011111000000000100111101110000101000001000101000010011001111001010101010101010011110010110100100110010110110010111101001011011110100101111100001100110000
1101100110000000001010110111000001110111111101100111101010001010011111011011110111011100001111111111000001100010001100011110011010100101011000011111100100000000111000010010000110011010100010111100101100010011111000110110011000011000101110011100011000100010
1001100100001100100100101011000011100100001000111010100111100000001100011011100000010011011010111010000101001100000001100100110010000111110101010101110110010100010001110100110101010010110011110010000010010100110000110011011111010110000111010011001100101000
1101000100001101100001111011001011010001001000110010001101100000101101111011100001000111011110111111110111001100001110010000010000000111010001011111110110010000011010010010000110011111110010010000100000100100001010110001111111100110111101011001101000100111
1001100000001010100010011011000001110111110000110111100010101010111110101100110001011110000011011101000101100000000011111011011010100001000101011111010100001001110000001010000110011011100011111110100010000011111000110101111001101010110101111010001100010010
1100100011000100011001111110010001110110011110100101001010010110000111010011010011000000101111101110101110010110001110110010000001010101011100001001110101001001011010010011001110011111011101100001001000110100011100010111110000000001101101000100011010111000
1110110010100111001100010100100011101110011010000111001010010011000101000001010101110000100001100110101110010100110111110100100011000110011100010000110101100101001011110100111000011100011011110101110000111100010000000010110000100000001100000001010001111000
1110100010000100001100110100100001100110011111000010001011011011000101011011010111110100100101101110101010010100101111110100000011100111011100011000100101100001001011110111111100011110010011010001110000110100011100000010110000100001001100000101011000111000
1011000111011011000100101011001000111000001001111010011100000000101101011100100100110011001111000011000000001010101100100101100010010100100000111011001000010000011000110001000001100000100010010000100110010100011010011001001001010010010111011111001100100011
