0011000000010101100001010100000100010000100001000010100100000000010101101111010000000010000110100001111010001000000010000000000100001000000000101000000000000011001010010011000001010101010000001000000000000000010010100100000101000000011001000000000000011101
0101100010000101000100000101000101010010011000011010001001010010010011011011000000101000011000100110011000000100010000110000100101001111111000010011101100100011000101111100010100110001000100010001011000000101101000110110010001010100000011010101000010101000
1101100010000101100011000111000001010010011000111010001001110010010011011011000001101001111011111110001000000100010001010000010000000111011101101011101100000000010101110110000110110000100000110000110000010111111000110110010000010000010011010101001000101110
0100011101000100110101000000111111000110010100001000101110110111100011100101000110010111110000111110111001000111010100110100010101111101110001010000100111100110000100000100111110100010011100100101011001010110100100000010010110011101111001010001110011000110
0100001111000100100101000000111110000111001100001000001100110111000111110111001110010001100000011110011000001110010100110100000101111101100001010000000111100110000000111100111010100100011100100101001000010110110100000010010110010101101011010101110111101010
0100011010000101111100000100110100101100111010001011111001111111010001101011010100100000000000100010001010100101010101100000010111011110101001100010001011101111000111100001101001100101011100000001011100100001000100000110010001110101011000000101100011111001
0001111000000101101100000100110100110010110010001111101001101111010001011011011100100100000000110010000000100001010101010001110111011011101001101110101101101010100111100000001000100100010100001001011101100001001100100110001001010101101010100100000011100000
0111010011000001101010010100100110010010001010001110101001111011100001001011000000000100111001000010001001100101010101111000110101101111001101101010001101100010000101110110010010110100001101010001011101100110000000100110010001001001011010010001100100101100
0101001111001100011101101010111101010000001010111110001111010100000001011111000010000100111010100110011001100111011100110100100100011101010000000011100111010010000100110001000100110010010100100001001101110001100110010111001110010001001010010101110010111101
1101001111000100110101101010111101010010001000111110001111010010000011011011000010000101111101100110011001100111011100110100010100000111110001000011101111100000000100110101000100110010010100110000001100110101000110000111010010010001000110010101011010101100
1100110100000001100110000000100011100011001000001000000000100011100111010001000011011101000000111110001101000101010101111100110011000101110101010000110111100101010111010000101110010111001011110101010000010100110000100010010000011111010111010001011000101010
0101000111000000011010011011010100110101101010111101110111011100001001111111011010101110101010001011001001110111011001000110110110001111000001010001000100010011000101010100010101010011001100000100001110010100110010110111000011010000000010010100000100111000
1011101100011000101100100011001010110000000011111010111011100000001100111110110101010011000011110011000101001001111101101011110010010011100101111111011100011000110001100000000101110010110011011010000001000000011110010011001011011000011111110010001110000000
0101111000010101110011000000000110000100101000011010101101101010000011101011000000100011010000010010011010001101010100100000110101011111100001100110001111100110000100010101111001110001010000010001010011100110101100010110010110010101011011010001100110101110
1101000100000000010000111111000011110110111001100010000111000010000101011001100001010011001111111110001100010100001011111000000010000111011100001001110110000000011011010011000100011110110011110000000100000100110000110011110011000010101101001000001000101000
1101100111000100000010010111000001110111111101100111001011011010010111011011110010001100101101111111001001110000101100011010011000100101011100011111100100000000111000110010000110011110110100110100101100000011100000110110010000011000101110011100111000100010
1101100101000100000010111111000001110111111001100111101010001010111111011011110111011100001111111110000001100010001100011111011000110101011000011101100100000000111000010010000110011010110010101100101100010011111010110111001000011001001110011100011010100010
1101101100011111000000100001001011100100001001001010111011000000100101111011100001110001011110100110101111101100111111010000110010010111110100000101111010010101110011010001101101110110110011010000000100110101111110110010110111000100001101001001101010110011
0101011110011100001000111011001001110101000010110010000111110000001110101010111001100011000111111001100000011001001011010000000000000011000000011001100010011010011111110011000001011111100000111110010101001101010010110001001011000010100011011111001100111001
1001000110001100101100101011001001110010001010111010100011100100001101011011000000010011001010110110000101000100000011110000110010000111110101011011110110011000010001110001000110111011000011110000100000000100110010010011011011010010000110010101001000101000
1111101010000001001100101110000000110110011011100010001001010010001011111111110001000011010110000111001100001100100011110010011010110111101000100011001110001001011001010001000110111000100000110100000010000111001100110011010011001000110110010101001110111000
0101000100001101100000101011001111010101001000110010001101100000001101011011100001000111011110111111110111001100001011010000010100000111010001011111110110010000111011010010000100011011110010110000100000000100101010110001111111001110111101011001101000100111
1101100000000110000001111111001011010111011000100010111011000010100001111001100001100011010011111011110101011000100110000000110000010111011100011101110110000000010000010111010000001000110011010100100100010101111000110001010111101000011111001001101100100110
1011100101000010000111111010111010010111010101100000011110110110111001010011100111010111110111010111010001011110101110011011001000110101000100111111001100000001111000110011001100001110110111010100101000000011010100001110010100001000111111111000111110110110
1100101011000100011001111110010001110110011111100101001010010110000011010111010011000000101101101110101110010110101110110010000001010101011100001000110101001001011110010011001110011111011101100101001000100100011100110110110000000001101101000100011010111000
1110110000100110001100010100100011101110011110000101011010010011000101010001000111110000100001100110101010010100110111110100000011000110011100010000110111100101001011110111111000011100011011010001110000111100010000000110110000100001000100000001010001111000
1110010010000000001100010100100001100110011011001111001011000011000101011011000100100000000101100110101100010100101101110000000011110111111100110000111111100101011011110100111100010110011011010001110000010100011100000010010011100001000110000101001001111000
1001101000000000000000000111000001110010011001010010101000000010001011011111100001010100010000100010000101000001100101101001110011000111011100111011111100000000010101010110001100111011100011111000000001100100101100110110111001010101010111000000001010100010
0101000110011111000111101011001100111000001111111110011000010000001100011110100100110010101110000011100000101010101000100100100100000100100000110011001000010010011000110001000001100000100010010010100010000100010010011101001010110110011111011111011100100011
1111000001011111000000101011001000110000001001111010011100100000001001011011100110111011001111110011000000000010101100100000100010010100110100011011001000010000011010110001000001101000110010010000100010000100110010011001001001010000000111011001001100101011
0101111110011111101100100000001001111001001000010010011001100000000001011111000000111000010010010011001100101100000101100000110110011110110001110010011011110100000001010001000001111000000010000001000010010100100000111010110011110000010011010100000110101001
