0100011111000100100101000000111110000110001100001000101110110011000011110111000110010011100000010110011000000111010100111100010101111101100001010010100111100110000100111000101010100100011100000101011001010110110100000010010110010100001011010001010111101010
0100011101000100110101000000111111000110010100001000101110110111100011100111000110000101110000111110111011000111010100010100010101111101110001010000100111100110000100100000101110100010011100100001011001010110100100000010010110011101011011010001110011000110
0100011111000101100110001000111101000100001100001000001100100111000011000011001010100001110010111110011010000110010000010100010101111101110001000000100111100110000100000000111110000100011100100101011000110000100100100011000110010101100001010101110011101110
1111001111000100011011101110111001010010001011111111001111011110000011011011000000001100111001100110011000100100110100110000000100010111010000101010101111100000000000110010000110100010011100110001001100110101000100000111010010010001100110010101101010101100
0101001111000100111101101010111101010010001101111110001101110110000001011111000110001100111010100110011001101111010100110000110100010101110001101011100111000000010100110001001100110010010100100001001101100101100110010111010000010001010010010101111010101110
0001000110011001111100000010110101010000100011110001000100011101111010011000111000010000101001000010000001000010001101001011000101001011010001100110001000011011110001100000000101100010100100101111001010100000000110000000001000000001000110110110001000000001
1100000110000001100110000000101011100010001000001000100000100010010111010011000010010101001000111110001001000101010100111100110011000101110101010010110111100100000111011000101110110111001011010101010000010100110000100010010000011101011111010001011000101010
0100000111000001111110000011001101100011001110111101110101110010010001111111010010101110101011001111001001100101011001010110100110001111000001110011100100101010000101110000100100110011001100010100101110010101110010010111000010011010000011011100011000111001
1110100101010110110111101011001110000001101100111000001010110000001001010111100111110101101001010010000000100110111100001100001001000110100001100111001010010010010000110001000001110000110000110100000110000100001010011010001000000001111111010001011110101110
0001000100011010011010111011000100110101001000110011000111001000101101111111100000010010000010001011100001011000000100100011011110000100000000001101000000011000111001010111010001010011100010110100100010010100110010111101001011011110100101111100001100100000
0001100100000010110010101001011110011110110000000011100110101010101010001000101001011100011010011111110111100010010011001001011000110010000101011000011110000010010000001110011110001110100011111011000100010011101100111001101101001110101001110011001110010110
1101100101000100000010111111000001110111111101100111001010001000111111011011110010011100101111111110000001100010001100011111011010110101011000011101100100000000111010010000001110011010110010111100101100110011100110110101011000011001101110011100011010100010
1001000110001000101100101011001001110100001010111010100111100000001100011111101000010011001000110110000101000100000001110100110010000111110101111011110110011100010101110000000110111011100011110000000000000100110010010011001011011010000110010111001000101000
0101000100011101100001111011001111010101001000100010011001100000101101111011100001100111011110101111110111001000001110010000010000010111010001011101110110010000111010010011000101011111110010110000100000000100011010110011111111001100111100001001101000110111
1101100000100110000001111111000011010111011000110010111011000010100001111101100001100011010011111011110101011000000110000000100000010111011100001101110110000000010000010111010000011000110011010100100100010100110000110001010111101000001111011001101100100110
1111100101000110100011111010011011001110000100110010001110101000101111110111100101010011100011110111010101011010000110011000010000110101010101101011111100000001010000010011000110001011110011110100100000010011000000000011110110101000111101011001101010110010
0011001100011000011100100011011110010100100011110111110000111100101000111010111000010010110011000011000111001011100101101011101100011010100000100111001010011010110001100001000001101000100110101010001011000011000110011000101000000100111000111010011110110100
1110101011000100001001111110010001110110011111100101001010010110000011010011010111001000101111101110101011010110101110110010000000010101011100001001110101001001011110010010001110011111011101100001001000110100011100010111110010000001101101000100011010111000
0010101010011000001100110110001001100000011101100000101001010100001100011111001111011101100101100110101001011101101111110111100110011101111000000001101000111001001111110001101100011111001010100100001001100100011110011010100010000001001001100111010010111001
1111000111011011000101101011001000111000001001111010011000000000101001011110100100111010001110000011100000001110101000100010100000010100100000111001001000010000011000011101010001100000100000010010100010010100010010011101001001010010011111011011001000100011
0101001010010111101100100000001101011001101000000011011001100000000001011111000000110000010010000010001100001100000001100100010101001110110001110010001010100110000001010001000001111001010010000001000010100101100100111010100011010000110001010101000110101101
