0100011101000100110101000000111111000110010100001000101110110111100001100111000110010101110000111110111001000011010100010100010101111001110001010000100111100110000100100000101110100110011100100101011001010110100100000010010110011101111011010001110011000110
1100001111000100010111101110101001000010001001011110001111010010000011011011000110000101111101100110011001100101011101110100100100011111110000100011101111100000000011110001000100110010011100010001001100100101100110000111010010010001001110010101111010101100
1101001111000100110101101010111001010010001100111110101101110010000001011111000110000001111011100110011001101111011100110000100100010111110001101011101111100000000100110001001100110010010100110001001101110101000110000111010000010001010110010101111010101110
0011000000011001011000100010010101010000100011110111000000111100101001011100011000000000110101000010000001010011101101101011100101001111010000100110001000011010101101100000001111100011100100101100001010000000000110010010001000011000011110110110011110100001
0110010111000100010111000000110110001000001101101000001001011111000011010011000010000111110001000010011000100110110100000100001101101100100000000010001011100011000000110000101011100000011100000101111100000011001000000111000110101001000010010101110101101110
1101001110000001100101101011011001010010001101111010101001110100001000111010111110000000111111110110010000101111001000111110010000110101110100111011101110001000011110110001000100110010100100000010001101100011011010010011001110010000011111011110011010101100
0001000100011010011010111011000100111101001010110011010111001000001101111111100000011011000010001011100111011000000000100011001110000100000000001101000000011000111000010111010001010011100010110100100010010100110010111101001011011110100101111000001110100000
1001100100000100000010111111000001110011111101100111001010001000111111011011100010011100001111111110000001100010001100111111011010110101011000001101100100000000111010010000001110011010110010101100101100110011110110110111001000011001101110011000111010100010
1101000110001000101100101011011001110100001110111110100010100100000101011011010100010000001000110010000001001100000011100110110010000101110101101011110111011000010001111000000100110011000011111000000010000000110010010011011010010001000110010101011010101000
1111100100000111110010110101001011110011001001000010111001100010000101111011100001110001010011100011011001011100100111010000100010010111011101101111111110000001110011110111000000111100110011010000000101110100011000110010010111000000011110001001101010110000
1101101010000001001100100010000001110110011011100111001000100010001011111111110001010010000110110111001000001100101011110110011010110111111000101011101110001001011001010001000110111000100010110100000010000110001000010010011011001000110110010100001110111000
1101100100001101100000111011001111010101001000100010011001100000101001111011100001100111011110101111110011001000001011010000110000000111010001011101110110010001111010010010000100011011110000110000100000000100101010110001111111001110011101001001101000110111
1111100100001100000011111111001011010001101001110011110011111000110001111001000001101011010111100111010011111001101010111001100000000111010101111111111100010001111010110111010100011110110101011000100001010001001010110101111101000010001101001000101000110111
1111100001000100000011110100100011000110111000000111001011001011000011010011000001000000001000100110111110010110110110010000000001100111011100011001110101100101000010010111110110011110011101010000100000010100001000100110110011000101101101000001001011111110
1110100001000100000001010100100011000110011100000101001000001011000011010011000001100000101000101110101110010110010110010000000001100111011100001001110111100101000010010110110110011110011001010000110000110100101000100110110010100101001101000101001000111110
1110101011000100011011111110010001010110011111100101001010010110000011010111010111000100101111101110101011010111101110110010100000010101011100011001110101001001011110010011001100011111011101100001001000110100010100010111110000000001101101000100011010111000
1110100010000100001100110100100001100110011110000101001010011011000101010011010111110000101101101110101010010100101111110100000011110101011100001000100101100001001011110110111100001110011011110101110000110100010100000110110000000001101100000101011010111000
1001101000000001000000000111000001110010011001011110101001000010000101111110000000010110000000111010000101001011100001101000110010010111011100101011111100000000010101010110000100111011110011111000000001010000111100110110011011010101010111000100001010100010
