0101101111000100101010100011001101010010001100111010101011111010011011011011100011001100111001111110000001100101000000000000111100000111000001001011000100000010010100011010000100110010110100010000001100100111100100110110001010010001010111011101011010101000
0100011101100100100101000000111111000110010100001000101110110111100011100111000110010101110000111110111001000011010100010100010101111001110001010000100111100110000100101000101110100110011100100101011001011110100100000010010110011101111011010001110011000110
0100011111000100110101000000101110000111001100001100101100110011000011110011000110000101100000010111011000000111010100101100101101111101100001100010000111100110000100111000111110100100011100000101011001010110110100000010010100010101001011010101010111101110
0100011111000101110110101000111101000110001100001000001100110111000011000011001110000001110010111110111000000110010100010100010101111101100001000000100111100110000110000000111010100100011100100101011000110000100100100011000110011101010011010101110011101110
1101001111000100100101101010111001010010001000111110111101110110000001111111000010000001110011100110011001101111011100110000110100010111110001101011101111100000010100110001000100110010010100000001001101110101000110010111010100011001010111010101111010101110
1001000100011010011010111011000100111101001000111010010111001000101101111111110000011010000110001011100001011000000001100011010010000110010000001101000000011000111001010111010001010011100010110100100000010100110010111101011011011010100110111100001100100000
1011010110101000001000010011001000110101000010100110100111010000001100101000111001100010000101111001000000011001101011110000000000000011000100011001100010011001011111100011000001011010100100111110111101001100010010110001001010000010100111001111001000011001
0101100100011101100000111011001111010101001000100010011001100000001101111011100001100111011110101111110111001100001011000000010100000111010001011101110110010001011010010011000101011011110000110100100000000100001010110001101111000110111100001001101000110111
1111101100010110000011111011001011011001001001100010110011101000011001101010100001100011011111100011010001111001101010001001100000000110010100101111101000000001111000111011000001011110110100011000001101010001001000111101011101000010001111011011101100110111
1110101011001000011011111110110001110110011111100101001000010100001001010111110111001000100111101110100011011111101110110010100000010101011100001001110101011001011110010011001100001110011101100001001001110001010100000111110010001001001101000100011010111000
