0000000000010100000000000000100000000100000010001001110000000000001000110000101010001010000000000001010000000100000001101100001001100000000100000000010000000110000001000000001011000000110001010001000010000110000010001100000100001010100000000010000000000000
1001001100011010011010111011000100111101001000111010010111001000101101011101100000111011000110001011101001011000001001001011000110010110000000000101000000011000111001010111010001010001100010010000000000010100110010111101010011010010000111111000001100100000
1001101100000100000011101111000011010111111001100011000011011000111111011011100010001100101111111110000001111010001100111001001000110101011000001111100100000000011010110000001110011010110110111100001100110011110110110111011100011001101111111000111010100010
1101100100001101100000111011001111010001001000100010011001100000101101111011100001100011011110101111110011001100001101100000110000010111010000011101100110010001011011010011000101011011110000010100100100000100100010110011111111001100011100001001101000110111
1101100100000110110011110011011011010111001000110010001010100010111011110011100001010011010011110111010101011110000110010000110000110111010101101111111110000001110000010011000110001010110011110100100000010100101000100010110111101000111111011001101000110110
0101001000000000000101000110010100010010011000000010101000000010010001101011000010000110010000000111001001000001000000000000100100011101001000010000100111000000000100010000001100100000000010101001001001010011100100000010001000011000000011010101010011101100
1000001000000110100001101100100011001010010000000000001000000011000001000011000000000000011000010110010001000011000100010000101000110010011100001100111001100000100000010010000100100101010001010000000000110100000100100011010000011001010001011000000110000010
