0001010100111010101100000010111110011000100111100111110000111101111010101000111110110000110001000000010100101011000001001111000100111000000001010110011000011011101100100000001011101000100110001010111111101011000100001000101110101011011000101010110101000100
0110000110000101101101001001001100000011101101001101110100110010010001111111010010011110111011100111001001101100111001010110100100001101100001110011101100100110000111111000100100110110000000010000100010010111010000010111010000000010010011011100011000111101
0001100010000001101000000101001100110111111010001111100001000010010011111001110001000110000010010111000000101001010011101010011010100111001001100001011110001111000101110110010110110100100010110000100100100110101000110000010001001110100010101100001100101000
1001000100011010011010111011000100111101001000111010010111000000101101111111100000101010000110001011100001011000001001001011111010000110000000001101000000011000111001010101010001010001100010010000000010010100110010111111010001011000000111111000001100110000
1001101101000100000011111111010011010110111101100011101010001100111111011011100010001101101111111110000001101110001100111001011000110101011000001111100100000000011000110010000110011010110110101100001100110011110110110111001100011000001111111001111010100010
1001000010001011010000111111001001111110010000110010010001000000001101011000100001000101011011101111000100010000000011010000001010000011010100001001010110010001010001010110010100011001100011111100100010001110110000111001111111111010100111111101001000001000
1101100100001101100000111011001011010001001000100010001001100000001001111011100001100011011110101111110011001100001011100000110000010111010000011101110110010001011011010011000101011010110010010100100100000100000010110011111111000100011100001001101000110111
1111100000001111000011111011001011011111001001100010111001001000111001111010100001100001011111111011010001111001101110011001100000000110010100101111100000010001111000111011000000001100110100011000000100010001001010111101001101000010001110011011101100110110
