0011000110011001001101000010010101010000100011111111001111011100101011011110011000101000101001000010000001110000101101101011100101001111010000100111001000011010100000101000010101100011100100101100001010000001000010010010001000001001100010110110111100100001
1001000100011010011010111011000100111101001000111010010111000000101101011111100000101001001110001011101001011000001101001011101010000110010000001101000000011000111001010111010001010001100010010000000010010100110010111101010011010010000111111100001100110000
0011101100010000101101100011001100110001100110111111111011111000001100111110111100010010000011010011000001001001111101001111111000010011100001110111001110011010110001100001000101110000110010011010000001000010011110011010001010011000011011110010011110000000
1001001101000100000011101111000011010110111101100011100010001110111111011011100010001001100111111110000001101010001100111001001000110101011000001111100100000000111000110000001110011010110110111100001100110011110110110111011100011000101111111001111010100110
1001011110111010101100101011000000100000000110111110110010110000001100001010110010110010101010011000000001001001010001000100110010000000100101010001000010011100010101100101110101010000100011011110000001001100110000011001010010011110000111011111011111001000
1011101000000110000011111011001011011111001001100010110001101010111001111011100001100011011111100011010001111001101011011001100000000110010100101111101000000001111001111011000000011100110000011000000101011101001000110001011101000010001110111001101100100110
0101100100011101100000111011001111110001001000100010011101100000001101111011100001100111011110101011110111001100001001100000010110000111010001011101110110010001101011010011000101011011110010010100100100000100000010110001101111010110011100001001101000110111
1111100100001101000011110111001011010001101000110011110001101000111001011001100001101011010111100111110111011000101010011001100000000111010101111101111100010001111010111111010100011110110001010000100000010000001010110101111101000010001100001000101000110111
1101100100011111100000111011001110010101001000100010001001100000101111111011100001000011010110101011110111001000000110100000110000010111010001011101010010010001111010010011000101011111110010010000100100000100000010111011111111000100011100001001101000110111
1011000100000000000010110111001001010010010000110111000011001000101001011001100001000000010101101110010100010000101111011011100000000011010100011101110100000001111011010110011100001111100011011000100000010000001010110100111101000010000110111000101000110111
1111100101000110100011110010111011000111100100110010001010101011101111110011100111010011100011100011111101011110000110000000101000010101010101111101111111000001111000110111011100001001110111010100100000110001010100001110110110101000011101011001111110010010
1111100101000010000011110010011010010111010101100010101010010110111011110111100111010011110111010111010000011110101110011000001000110101000100111011000100000001011000110011001110001110110101110100101000000010000100000010011110101000111111011000111110100110
0001000010000001111000001101000100110010011011001010110001000010001101011111100000001110001010000011000001000001010001010000110010100111001101101011011100001010000101010010000110110001100011010000100010000110111000110101011011011110010010011101001000101000
0101000111011011000110101011011100111001001101111100111100010000001001010011100110111010101110000011100000001110101100100110000110010100100000100001000010010010011000010001000001100000100100010010101010010101001010011111000000110000001111011111011100100011
0101001010010111101000100000001100111001001010001111011101110010010001111111010100100000010010000011001000001100010001100000010110001110100001110010001001100010000001010101101001110000011100000001001010100100001100011110010001011100110010010101000110111001
0111001010000101101000100001001100011011001010001111011101110010010001111111010100100010010000000010011010001100010001100000010101001110000001110011001000100010000101110111000001110000010100000001001011000101000100010110001001010100111010010100000110101100
