1101001110001000101100101010011001110100001110111111110111100100001101011111011100110000001010110010000001001100000011000110110010000101110001111011100111011000010101111000000100100011100010001100000010000000010010010111001010011000010110010110011010101000
0101100100011101100000111011001111110101001000100010011001100000001101111011100001000011011110101011100111001100001001100000110010000111010001011101110110010001011011010011000101011011110010010100100100000100010010110011101111010110011100001001101000110001
1100111001101110010001010111101010001110010100100000111000100001101100100100101110111111110101011100110101011011001100010101101001010000001100001100010100000100111110000000101000001100110011011010010001101110110100001100100110111011001101011011111101000110
0100001101000100111101100000111110010110011100111000011010110111000001110011001010000011110010010011011001001110010100000100011101111111100001000110001111100010100000100001001111100011011100000101001000100010000100000010000100011000111010010000110111100100
1100110101111110000101000100111011001100010100000000111010000101100101100100100110011011110100011101111110001010001100010101011001110000111100000100110001110100001010000000111011000100011011010011111001011110101110001100110100111100011101001001110001000111
0100111101111110000101000100111010001100010100001000111010000101101100100100101110010011110100011001110101001011001100000100111000111000101100000100010001110110101010000000111001000100011011001111110001111010100110001110100100111001001101001011110111000111
0100011111111110100101000000110100001000010101001000101010000101001000100011001110010101110000011000011111001111010100000100111100111100101000000000010001110110000110001100101011100010011110100111001011101010100110001010100100011101101001000111110111001111
0100011111010100100101100000110100001000001100001000101010100111000000100011001110010100100000011010011111001111010100000100111100111100101001000000010001100110000100000000101011100111011110100101001011100010100100001010100000011101011001000110110111101111
0100111011010101100101000100110100001010000100001000111000100111000000100111001110010010100010011001111101001111010100000100011100111000101001000000010001100110000110000100111011100100011111100111011101110000101100001010100000111100010000000110110111001111
0100000110000000100101000000101101000001001100011000111110110010000111110011000110010110100000111110001101000111010100010100010101111101110001000010100101100100000000110000111110110011001010110101010001000110110110010010010000011101101011010000011010101110
