1101100100001101100000111011001111110001001000110010010001100000001101111011100001000011000110101111101011001100001001100000110110000111010000001001100110010001011011010011000101011010110000010000100000000100010010110011111011010110011100001001101000101001
0100000001000100000001000110100110000001001000111000111000010010000011110011000010000001110010000111011000000110010000010100000100101111000001110000100111100010000100010100000110010010011100000000001000010110000010110010010110010000001011000001011000101110
1100111001111110000101010110111010001110010100100000111010100001101100100100101110111111110100011100110011011011001100010100101001010000101100000100010000010100111110000000101000001100111011011011110001011010110110001100110110111011001101001011111101000110
0100001101000100110101100000110110000110001110111000011010110111000001110011001110000011110010000011011001001110010100000100011101111101100001000110001111100010100000100000001110100011011100000001001000110010000100000011000110011000011010010001110111100110
1100110101111110000101000100111011001100010100000000111010100001100101100100100110111111110100011101111010001010001100010101011001110000111100000100100001110100101010000000111000000100011011010011111001001110111010001000110110111100011101001001111001000111
0100111101111110010111000100111010001100010100001000111000000101101100100100101110010011110100011001110101001111001100000100111000111000101100000100010001010110100010000000111001000100011011001011110101001010100110001110100110111001000101000011110111000111
0100011111011100100111000000110100000100001101011100101110010101001000100011001110010101110100011010111011000111010100000100011100111100100000010000000011110110000100000000111111100010011110100111001011110010100110001110000100011101111001000111110111101111
0100011111111110100111000100110100001000010101001000111010000101001000100011001110010111110010011000011111001111010100000100111100111000101001000000010001110110000110000100111011100110011110100111001111111010100100001110100110111101011000000111110111001111
1100111101100100110101000100111001001011000100001000111000100111100011100111001110111111110000011101111110000010010100010100010101111000111001000100111101100100100110000100111010100100011011000101011000011000101100000110110110111100110000000001110011000011
0100111011110100110111000100111100001000010100001000111000000111000000100111001110010011110010011001111101001111010100000100011100111000101001000000010001100110000110000100111011100100011111100111011001010010100100001110100110111100010000000111110111001111
1100000100000000100101000000101011000011001000011000101110100010100111110011000110010101100000111110001111000100010100010100010001110101110101010010110111100100000100010000101110110011011011110101010000000110110100010010010110011101111111010000011010100110
1000111100000000100000010100001001000110010000000000110010100010000001110001000001000010000000111110101101000001000010010000000001100101011101001000110101100100010110000110111100001110000001010101010001000010100000000000110000001001100100000000001010100000
