0101111000000100010100000001000110100000001000001010001101010000000101001011000110000001111000000010001000000100010001000100010110011110100000100000001011100110000101110000100000010000011010000001010100100100011100010010010010000100001011000001010010101000
1011100000110010100100100011000011101001001100111110100000010010110001111100100111011011100011010001001000001000111001001111011010000010110101110011001000001000010001110000000001110000100010010000110000001100011010011000010000110010010111101000011100000010
1000100100001000010001010110101011000110110000100010000111010001110011010001100001001101001101101110110000010000001110110001000001010011011100001100110110011001111111111110011110001110110001110001010000110000100110100000010101000011101100100000101000010111
1001001101000100000011100111000011010010111101100010000011001100111111111011100010001001100111111111010001101010001100110001001000110101011000001111100100000000011000110011001110011010100100101100001100110011110110110110011100011000101111111001111010100110
1011010110110010001001011011001000111101000010100111110111010000001000101000110001000110001101011100000001010000101010010010100000100010000100011001010110001001011010100010000000011000100101011010110100001010010010111101011011100010000111001111001000011000
1111101110000100011100100010000001110111111011100111101010001010001001111011110011011010000111111111001001001110101001111110011010110101110000001011101100001000111001011001000110101010100010110100000011000110001100010110011011011000110111010100011110101000
1101001110001000101101101010011001110100000110111111101111100000001100011111011100110000001010110011000001001100000010000110110000000101110101110011100111011000010100101000000100100011100011011100000010100000010110010111001010011000010110010110011110101000
0101100100011101100000111011001110110001001000100010001001100000001111111011100001000011010110101011110011001100001001100000110110010111010001001101010010010011011011010011000101011110110010010000100100000100000010110011101111010100011100001001101000110101
1111100101000010000001110011011010010111010101100010101010010100101011110111100111010011110111010111010001011010101110011000001000110001000100111011000110000001011000110011000110001010110100111100101000000010000000000010010110101000111111011000111110110110
1111000111011011000111101011001000110001001100111100011000110000111001010111100110110010110111000011000000001110001100100110101000010100100100011011001000010000011000110001000001110000100010010000100010000110000010011111000000110000001111011101011000100111
0111000111011011000110101011011100111001001101111101111000010000001001010111100110110010110111000011000000001110101100100110000010010100100000110001001000010000011000110101010001110000100100010000101010000110001010011111000000110000001111011101011100101011
0100000101000100000001000000101110000010011000101000101100110010000011110011000110000111110000000011011001000111010000010100000101111111000000010010101111100010000100010000001110110110011100100001011000010110000100010010010100010000111011010000010000101110
0100000101010000111001100010011110010110001110101000111111111110001001011011000010000101100000001010011001000101010101000100001101011111000001000001000010010010000001111000001001110000011100100100001001000100000100111010000010011001011010010001111110100100
1100111001100110000001010110101010000110010100100000111000110001101100100100100110101111110101011100110001010011001100010100100001010001001101000101000100000010111100000010101000001100111101010110011001001110110000001100100110111011001101011011111101000110
0110011101000101000111010011110100010110000100100000101100100101001110100000101110010111110101011000110101010011101100000100100001010001100001011100010100000010111100000100011110001000110010101111011001000010010100000100001110011001101011010111111111000110
0100001101000100111101100000111110000110001110111000011110110111000001010011001110000011110010000011011001001110010100001100011101111101100001100110001111100010100000100000101011100000011100000001001000110010100100000010010110011100011010010001110111100110
1100110001111110010101010110111010000110010100101000111010010001101100100100101110011111110100011100111011011111001100010100101001110000101100000100000101110100101000000000101000000100011111000110111001011110100010001100010110111001001101001011111101000110
1100110001111110000101000110111010001110010100000000111010100101100101100101100110111111110100011101111010001110001100010100101101111000101000000100000001110000101010000000111000000100011110000010111001011010101010001110110110111101011101001001110001000111
1100011101100110110101101000111011001110101100011000001110110111100001010011000110000101110010100000011101000110010100100100111101111100110101100110111011100100000000101000101110100010011101100001011000110100001100001011010100111100111110010000110111000110
0100011111111111000111000000110100001100010101011000101010010101001010100010101110010101110000011000011111001011000100000100101100111000100000010010010001110110000100101000111111100010011110100111001011011010100110001110100110111101101001001111110111001111
0100111111000100100111000100111100001000010100011000101010010111000000100111001110010011110010011001111101001110010100000100011101111100101100000000000001100110000110000100111011100110011111100101111101100000101100001110010110111100010010000101110111001111
0100011111010110100111000000110100001000001101011100101010110111000000100011001110010101110000011010111111000111010100000100011101111100100001010010000011100110000100001000101011100011011010100101001011010110110100001110100100011101111001000101010111101111
0100010100000000100101000000101111000001001000011000101110100010100101110111000110010111000000111111011111001101010100010101011101111101110101010010100111100100000100011000111110110011011011110101010001000110110110000010010110011100111011010000011010100110
1001100110100000111000000001001000110110001010010010100001100010111111111000110000001110011000010100000100101001010001011011011010100011000101101011011100001010110101010010000110111010100011111110110101001111010000110000011001011111110110111110001100100000
1001100110000000101000001001001000110110101010011010100001101010001111111001110100011100001010010110000101100000010001000011011010100111100101101011011110001000010001110000000110110010100011110100100100100110011000110001011011111111010110111100001100100000
0000011001100000011010010100110110010111100110011001111111011111110000100110011010001010110000001000111001010111010110000101100101011001001000000100000101101010100100001100011100000011011100001011011001011001100100100110001000001001001010000010110011010100
1100101010000100100111000100100001000111011100001000111010111010000101110111000110010011100000110110011111000111010100010100110001011101111101010010111111100100000010010100111100110110011011010001000001010100111100000010010110011100011011000101010010101010
0000011001100000011010010100110110010101110010111001111111011111111000100110011010001110110000001000110001010011010110001101100101011001001000000100000101101010100100001100011100000011011100001111011001011011100100100110001000001001001000100010110011010100
1010111000001001100000001100101001000010010000000010000000100011000001000001000100110100000000110110001101000001000000110000100001010001011100001000110101100100011110000010101100001110001011010101010001110100001100100011110001011001010100000000000011000001
0000011101000000100000000100111100000100001000001000110001110110000010100011001000000010100000011110001000001001010000010100010101001101100001000010100101100110000100000101101100100100001100001001011001100010100100100010000001010101110010010000000011000000
1001111100000000100000010100101001000111010000000010110011100010000001110001000001010010000000111110101111011001000010010000000001100001011101001000110101100100010110010110111100001110000011011101010001000000101100100000110001001101000100000000001011000000
0000010101111010000100001001010100001101001101011000100110010100001010100000101110000010101010000001000001001101010010000100001100101100100001000001000000010111000100010100110011000001101100100110111001001010100000011001000000111100100010011010000100110000
0000111000000000100000000100000100000110000000001000100000100010000000100000001000000010000000011110000011000001010010010000010101101001000001001010000100000010000100000110000110100110000000100011010001100010100000000000000000011101010010010010000000000000
0000011100000000100100000100000100000110010000001000110110000010000001110001000000000010000000101110101001011001010010010100100101001001101001000000100100100111000110100100110100000111000000000101010001110010100000000000010000001101000010000000000000010000
0000000100011010100100101010001100000101000000111000110110100000001000100000101000000010000010000001000001001000010000000100011000100000100001100011001000010011010000100000000011100011100000100110100000011010100010001001000000111100110110011010001100010000
