0001110001110000011101000001000100010000001010001010000001010100000000101011001110000011111000010000111010000101010001000101010101001110100000100100001011101110100101010000100000110100011100001001011001000000001000010001101110010111010000100000110000100100
1011101000011010001101000011000000110001100010101111001001001000101100101110110100010010000011010011000100001001000101001011010010010010100100111111011010011000110001100000000000110000110011011010000001001000011100010000001011010000011110101010001010000000
1011100000110010100100100011000011101001001100111111100000010000110001101100110111010011100011010001001000001000111001001111010010010010110101110111001000011000010001110000000001110000100011010000110001001100011010011000010010110010010111101000011000000010
1011100010101010110100100011000001101011101000111010010001110000110101111001100101101011000011010001001000000000110001000001010011000011110101100011101010110000010001110001100011110000100011010000110000001101011010010000010011100010010111111101001100000010
1010101101110110110101101011001000001000100100111000111010110000011001000010100111000001111111010010010000001011111110100101011000010010100101110011001010010000000000111001000001110000110000010010000011101110001110011011010110000001111111111100011110000110
0001101001011001010111010011110101010000000101110010110100010100111000111110101011010111110101101011010001011011001110001111100101011001010000001100000100011011111100101100011101011011100110001111001011000001100110010000001100001011001011110010110010010111
0001101100011001000111000011010101010000000101111010110000000100111100111100101011011111110101101010010001011011001110001111100101011001110000010100000100011011111100001000001101000011100010001111001011000001100110010000001100011011001011110010111010010111
1001001101000100000011100111000011010010111101100010000010001100111111111011100010001001100111111111010001101110001000110001001000110101011000001111100100000000111010110011001110011010100110101100001100110011110110110110011100011000100111111001111010100110
1011010110111011001000011111001000111111000010100111110101010000001010101000111001000110100111010001000001010000101011000010101010100010000100111011010010011001011010100010010111011000100101011010110100001110010010111001101010101010000111001111001000011000
1111001110000100101111000010001001100000101111111111111111111010010101111111000110001100101001100011001001101101111011101110100000000111110101100011101101100000000101110000000100100010001100110000010001100101010010000110010000011000010110010101111001111100
1111101110000110011100100010000001110111111011100111101010001000001001111011110011011010000111111111001001001110101101011110011010110101110000001011101100001000111001011001000100101010100010110100000011000010101100010111011011011000110111010100011110101010
1100000111000001111000101000001001100010001010000111110101100010000001010001010100000000001001100110001001000010101001110010011010100111110101111010101111101000001011011010100110111110001101110000101000010110011000110101110001111011110101011100001000111001
1101001110001000111101100011011001110100000110111111111110100000001100011111011100110000001010110011000001001100010010000110110000000101110101110011100110011000010100101000001100100011100011011100000010100000011110010111001010011000010110010110011110101000
1111100100001101100011110111001111010000101000110010110001101000110001111001100001100011010011100111110111011100100011010001100000000111010001111101111110010001111011111111010100011110110000010000100000010101001010110000111101000110001100001001101000110111
1001000100000000110000101001000011110111001000000010010111100010100111111011100000100011011011110011011000001100010001000001000010000111110101111111110110000000010001110111010000011000110011010100100000010100100000110001010111110110001111111001101100100110
1101100100000110110000101001001011010111001000011010001011100010100111111011100001010111010010010011010101001100010111000000110000110111010101101111111110000001110001010010000110110010110011110100100000010100101000110001011101101110111111011001101000100110
1111100101001000000001111111011010010011010101110110101010000100111011111010100011000111110111011111010001011010101110010000001000110001000000001011000110010000111100110010000110001010110100111110101000000010101010111001001100101000101110011011111000100110
1111100101000010000001110010011010010111010101100010101010010100101011110111100111010011110111010111010000011010101110011000001000110001000100111011000110000001011000110011000110001010100100110100101000000010000100001010010100101000101111011001011110110110
0011010010010001001100001101000100110000011011001010110101000000000100001111001000100110001100100000100010010001111001100000100110001110101000100001101000100110000111110101110001110101100010010010010011001100011010110101001001010111000010001111000000100001
0101010101111011000111101011000110011101001101110101100100010000101010101100101100101010101011000001010110001010100000000100100100001000100000100011001000010010010000110001000001111000110000101010100011011100001010011101101100110110001001011011111100110111
1100010110110111001111101010011000001011001110011101011000011101001000000010110010111110111110000001011000000110001100100110001100101100100000010001001000101001110010001001000001100000010010000010110000001010000010001111001000100000001010011110010101101110
1011100101011011000111101011001000111001000101111100111000010000101001010000100110111010100110000011100000101010101100101111001000110000100000111001001000010000011000011101010001100000100010010010100110000110011010011001001010110010011111111110011100100011
0000010001000000001101000111000100100011001110111001000000010100001010101110011110101010100000000101000000000101000001100100101111101101101000000000001100010110000101110000100000110000001100100011011001010110100000010100001000010110000011010010010100101100
1111000110000001100000101001001001110010001000001010011001100010000001011001000000101010000000110010001000000001010001110000110001000111010101101010111010100000000111110111010001110100000011010001010011000100110000110011010001010101010011010101001100100000
0111100010000101100000101001001101110010011000011110011001100010000001011011000000100010000000110010101010000101110001110000010011000111011101111011101100100010000101010111010000110000100000010001010011000100010000110011010001010101010011010101001100101000
0100000111000000100001000010000100010110001000111000001100010110000011110011000010000011110000000011111000000110010100000100010101111101000000010000000111100010000000010000010110010010001100000001011001000110100100010010000100011100001001000101010010101110
0001001000010000111101100010100111100001011110111010111111111010000101011011000010100001100000011010001001010001010101000100100100010111010001000100000110111000000001110100011101010000010100010000001000000100110100010010010010011001001110010001111110100000
0001001000010110001101110111000110111110111100101011110100010010101101111011011010010010100000011010100011011001010100000101001100011100001000010101000010011010100000010101011001010000110010001100000001000110110100011000001000011110001001100010011110100000
1101000000010100011100000010110111110100110110111011111111000000100101011101010100110000000000010010001001000001010100000000100011010001110001001100000010010000110000111100011101000000110010011001000001010000110110010100011001011001001110010001101110100000
0101000100000000000101100101001110000100011100001010000100010010100111011001000110010001110010010110111010001110010000010100011101111100101000010001001110100110000010110001101010110110010010110000100000110110110000010000010100010110111001000001111000101110
0101011111010101100011010010111100010101001100111010111101010101000001010011001000000101110100111010111011010111011100000000001101111110000000011100000011110010101110000010011111000011011100101101011001010010110110100110001101011101011001000101100011101111
1100100001100110100101000100110011000110011100000000011010100011100101110101100110111111110000111100011100000010000100010101010001000001111101010110110110100100010100010101100000101100111011010000110001001100111000000000110100110111011101011001111000000110
0100011101000100111101100000111110000110001100001000101110110111000011100011001110000011110010010111011001001111010100010100111100111101100001100110001111100010100100101000101110100110011100000101001101110010000100000010010110011100011010010001110111100110
0000011101000100111101000000111110010111100110011000111010111111100011110111011110000011110010010111011001001111010100010101111100111101100001100110001111101010100100100000001110100010011100001001011101000010000100000010001110011100011010010000110111100100
1100110101111111100101000100110011001111010100000000111010100101100110100100101110111111100000011101111110001111000100010100110000110000110101010100110001110100101110000000101010101101011011000111110001001010110100001110110100110101011101000011110001000111
1100110001101110100101000000110011001110010100000000111010100101100111100100100110111111110000111101011110001010000100010100110001110000110101010110110101110100100010000000101110101110011011010111111001001000111100001110110100110100011101010000110011000111
0100001101000100110101100000111010000110011100001000111110110111100001010011001110000001110010110110011001001111010100100100011100111101100101100010001111100110000000101001101110100010011101100001001001110010100100000010010100011101111010010001110111101110
0100011011111111010111000100111100001100010100000000111100010101001110100010101110010111110100011000111110011111000100000100101100111000101000000100010001110110001110000100111011001100011110100111001001011010100110001110100110011101001001000111110111000111
0000111100100000100101000000111011000111110100001000001010100111100111000111001110111111110000111100111110000110010100010101110101011101110001010100111101100100100110000100111110100110011011000001010000001100111100000010110100110100111001100000110011000111
0100111111000101110111000100111100001100010100001000101000100111000100100111001110010011010010011001111110001110010100010100011101111000101001000100010001100110100110000100111010100100011011100101011001010010111100001110100110011100110000000101110011001111
0100011011010100100111100000110100000101001100011100111010010111000000100011001010010111110000011010111011001111010100000100011100111100101001010000000011100110000100000100110011100010011100000101001011010110100100000110010100011101111011000101010111101110
0100001100000100100101000000101111000011001100011100101110100010000101110111000110010011110000111111011111001101010100010100011101111101110001010010100111100100000100010000101110110011011011110101010001010110110100010010110110011100011001010001011010101110
1001100010100000101000000001000000110010101010010111100001100010111111111000110000001110001000010100000101101001010001011011011010100111000101101011011100001010110101010010000110111000100011110010110001001111000000110100111001011111110110111110001100100000
0010010001110010111101000010111110011010000010111000000000110111101010000000111110000101110001011000010000000011011100100101011101111010000001000110001011011010100100100000001011100000001100101111111000001010000100001000001110110011101010110010110101000100
0010110101110010111101000010111110011001100010111000000010111111101010000000011010000101110000010000010000000010111100100101011101111010000001000110001011001010100100100000001011100000001100101111111000101010000110001000001110111011110010110010110101000100
0100011101000000110111000000110110000100000100001000111110110111100000100111001010000111110000100110011001000011010111010110100101011001100001000000100101100111000100100000101100100111011100000101011001010000100100000110000010001100001010010001110011010110
0100011011100100011010010100110100010110110010001001111101011111010000100110011000001110110000011100111011010111010110010000100101011011001000000100100101101010100101001100011100000111011100001111011001011001100100100110001000001001001000000111100011001000
1100101011000100100110000100000111100111011100001000111010111010000101110011000110010011100000111110011011000111010100010100010011101101101101110010101111100100000100110100110110110110001001010101010001010100111100000010010010011101111011010101010010101010
0001011001000100011000010100110100010111110011101001111111011111011000101010011010001110010000011100110001010011010110001000100101111001001000000100000101001010100100001110011100000111011100001111011001010010100100100110001100001101001000100110100011000100
0000011000000000100100000000110100000100010000001010100101100111000000100010001000000110000000011000001001000001010000000100011101011011100001000010001101100110000100000000101100100110001100101011011001101000101100100010001001011101010010000010000111000000
0000011101000000100100000000110100000000011000011000110011110110000000100011001010000010100000111110001010000001010000010100010101101101100001000010101101100110000100000100111110100111001100001101011001100000100100100010000000011101010010010000000011000000
1001111100100000100000010100101001000110010000000010110011100010000001110001000001010010000101111110101101010001000010010000000001100001011101001000110101100100011110010110111110001110000011011001010001100000101100100000110001001001000110000000001011000000
1010011100101001100000001100101001000110010000000010010100100010000001000001000100110100000000110100001101000001000000110000100001000001010101101010111101100100011110000010101100101111001011011001010001111000000100100011110001011101010100000000000011000001
0010110100000000100100000000001100001111000000001000000010110010000011000011000001000100000000000010101110000000010000100100011101101100000101100000011101100110000100100100111010000101001001110101110000010010100000000000110000101101110000010000000101100000
0000010100000000100100000000000100000100000000001000110100100010000001110001000000000100000000001110001001000001010010010100000101101001100001000000000100100111000100100100110110000111000000000101010001110010100000000000010000001101000010010000000000010000
0000010100000000100100010000000100000110000000001000100100000010000001110001001000000100000000001110101001010001010010010100001101101001000001000000000100100111000100100100110110000011000000000101010001110010100000000000000000001101000010010000000000010000
1010000100001000100000010110001001000100000000100000100110000000000001110001100000000110000000110110101111010001000000010000100001000001010100001000111100010000011010000110010100001110100001100101010001000000100010000000110000001101000100000000001000000000
0000001100111010100100100010000100000101000000111000100110100000001000000000100000000010000010000001000001001001010000000100011000000000100001000011001000010011000000000100110001100001100000100110000000011010100010001001000000011100110110011010001100010000
