1011101000111010001101000011000010111001100110101111000001001000101100101100110100010010000011010001000000001001000001001111010000010010100100110111011010011000110001100000000000110000100011011010000001001100011100010000001010010010011111101010011010000000
1101001110000110100011101011001000010111001000111111111111100010001001111111110000010010010010110011010001001100010000000010011000000111010101111011011100000000010000110011000001110000100011011000000001010110010000110111011111010000010111011101001110101110
1001001101000100000111100111000011010010111101100010000011011100111111111011100010001001100111111111000001101010001100110001001000110101011000001111100100000000111010110001001110011010100100101100001100110011110110110110011100011010101111111001111010100110
1011010110111011001000011011001000111101000010100111110011010000001000101000111001000110001111010101000001010000101011000010101010100010000100111001010110011001011011100010010010011000100101011010110100001010010010111001001010100010000111001111001000011000
1111001110000100011100101010000001110111111011100111101010101010001101111111110011011010000111111111001001001110101101011110001010110101100000001011001100001000111000011001000110111010110010110100001011000110001100010111011010011000110111011100011110101010
1100100111000011101000101000101001100010001010000111110101100010000001010101010100000010001001100110001001000110101001010010011011100111110101111010101111101101001011011010101110111110001101110000101000010110011000110101110001111011110001011100001000111001
1101001110001000111101101011011001110100000110111111011111100100001110011111011100110000001010110010000001001100000010000110110000000101110101110011100110011000010100101000000100100011100011011100000010100000011110010111001010011001010110010110011110101000
1101001110011000101100101011011001110100000110110110000111100100001110011010111100010010001000110010000101000101000011000100110010000101110101101011111010011100010101000001100100111011100011101110000011000000011010011011101010011000010110010111010011111001
1011011000100111000010111011001011011111001000100010110001110010010101101011000001100011011111100011010001011001101001010001100010000110010101101111101010000000111101110011000000011100110101011000001101011101001000110001011101000010001110111001101100100100
1111100100001101000011110111001011010001101000100010110001101000111001111001100001101011011011100111110111011100100011011001100000000111010101111101111100010001111011111111010100011110110001010000100000010101001010110000111101000110001100001001101000110111
0101100100011101100000111011001110110001001000100010011001100000001101111011100001000011011110101011110111001100011001100000110110010111010000001101010010010001011011010011000101011110110010010000100100000100000010110011101111010100011100001001101000110101
1111100101010110100001110010111011010111101100110010001010101011101011110011100101010011100011110011111101011110000110100000101000010111010101101101111110000001110000010111011100001000110101010100100000010001011100101110110110101000011101011001101110110010
1111100101001000000001111011011010010011010101110010101010000100111011111010100011000111110111011111010001011010001110010000001000110001000000001011000110010000111100110010000110001011110100111110100000000010101010110001001100101000101110011011111000100110
1111100101010010100001110010111010011111110101100010011010111110101001110011100111010010100011100011010101111110101110100000001000110100010101111111011100000001111000110111001100001110110101010000100100100011010100001010110100001000011101111000111110110110
1111101101000010000011110010111010011111010101100010111010110110101001110111100111010011110111000111010000011110101110111000001000110101000100111111011110000001111000110011001110001110110101110000100100000010000100001010010100101000111111011000011110110110
1111100101000010000001110010011010010111010101100000101010010100111011110111100111010011110111011111010000011010101110011000001000110001000100111011000110000001011000110011000110001010110100110100101000000010000100000010010100101000111111011001011010110110
0101010101111011000111001011000110011100001101110101000100010000101110101000101100101010001011000001010110001011100000001000100100000000100000100011001000010010011100110001000001111000110000101010100011001100001010011101101100110110101001011011111100100111
1011100101011011000001101011001100111001000101111100111000010000101001010000100110110010100110000011100000001010101100101111001000110000000000111001001000010000011000010111010001100000100010011010100010000110011010111001001000110010010111011010011100100011
0111000010000101101110100001001101111011011000011110001001100010000111011011001100100000001010100010101010001100010001100100010111001110111001100010101001100110000011010001101001110100010010100101010010100100011100011111101001010100110000010101000110101000
0111100010000001100000101001001101110010011000011010011001100010000001011011000000100000000000100010101010000101110001110000010011000111011101101011101100100010000111011111010000110000110000010001010011000100010000110011010001010101010011010001001100100000
0100000111000000100000000000000110010100001000011000101100010110000001110011000110000011110000000011111011000111010100000100000101101101000001010000000111100010000100010100001111110010011100000001011001000100000000010010000100011000010001000001010010101110
0001001101010000111001110010001110110011011110101000111101111110101101011011000010000011100000011010101001010101010100000100001100011111001001000101000010011010000001010000011001010000010100100100001001000100110100111010000010011001001010110001011110100100
1101000100010100011100000010111111110100100110111011111111000000100101111001010100110000000000011010100001010001010100000000100011010001110000001100000010010000110001111100011101000000110010011001010001110000110100000100011011011001001110010001101100100000
0100000100000001100101100101001110000110011100001010000100110010100111010001000110010001110010111110111010001110010000010100011101111101101000010001101110100110000010110001101110110110010010110000100000100110110000010000010100010110111001000001111000101110
1100100001100110100101000100110011000110011100000000011010100011100101110101100110111111110000111100011100000010000100010101010001000001111101110110110110100100010100010101100000101100111011010000111001001100111000000000110100110111011101011001111000000110
1100010001101110100001000100100011001110010100000000111010100011101110100100100110111111110000111100110110001011000100010100110001010000110101110110110001000100111110000000101000101100111011011111110001001100010100001100110110110101011101011011111001000111
0100011101000100111101000000111110000110001110001000111010110111000011100011001110000011110010010111011001001111010100010100111101111101100001100110001111100110100100101000101110100110011100000101001101110010000100000010010110011100011010010001110011100100
1100110001111111100101000100110011001110010100000000111010100011100110100100101110111111100000011101110110001111000100010100111000110000110101010100110001110100101110000000101010100100011011010111110001001010010100001110110100110100011101000011110001000111
0100011011111111010111000100110100001100010100000000101000000101001110100010101110010011110000011000111110001111000100000100101100111000101000000100010001110110001110001100111011101100011110100111001011101010110110001110100110011101101001000111110111000111
0100101101000000100101000000111111000111001100001000001010110111100011010111001110111101110000110110111111000110010100010100110101011101110101110010111111100110000110000100111110100110011011000001010000000100001100000010110100010101011001010000110011000110
0100111111000101100111000100111100001110010100001000101000100111000100100111001110010011000010011001111100001110010100010100011100111100101101000100110001100110100110000100111010100100011011100101011001010010111100001110010100011100110011000111110011001011
0100011011000100100111100000110100000100001100011100111110110111000000100011001110010101110000011010111011000111010100000100011100111100101001010000000011100110000100001100110011100010011100100101001011010110100100100110010110011101111001000101010111101110
0100000100000100100101000000100111000011001100011100101110110010100101110111000110010111110000111111011111000101010100000100010101111101110001010010100111100100000000010100111110110011011010110101000001010100110100010010110110011100101001010001011010101110
1001100110100000101000000001000000110110101010110111100011101010111001111000110000001110001000011100000101101001010001011011011011100011000101111011011100001010110101010010000110111000100011111110110101001011000000110100111001011111110110111110001100100000
1001100010000000111010001001000000110110001010011010110001100010111111111001110100011100001010010110000101100000010001001011011010100111100101101011011100001000110001111000000110110010100011011100100100100111011000110101011001111111110110111100001100100000
0100111011000100100111000100110101000110011100001000101110111111000101110011001110010010100000100110011101000111010100010100110100101101111001110000101111100110000000110100111110100110011100000101001000010110011100000110010110011101011011000101110011101110
0100011101000000010111000100110110000110010100001000111110110111110000100111001010000011110000100111011011001011010111010100000101111001100001000000100101100111000100100100101110100111011100000101011001010010100100000110000010011100101010010001110011010110
0100011111000100011111010000110100000111010010001000111101011111010000100110001010000010110000001100111001010111010111010100100101011011000000000000100101100110000101100100111110000111011100000111011001010010100100100110000000001001001010010111110011011100
0100100111000100100111000100100101100110011100001000101000111010000101110011000110000011100000100110011101000110010100010100010101101101110001100010101111100110000000010100111110110110011001010001011001010110111100000110010110011101011011010101010010101010
0100011011000100011010010100110100010111110010001001111111011111011000100010011010001110110000011100110001010111010110010000100101011001001000000100000101101010100110001100011100000011011100001111011001011011100100100110001000001101001000000111110011001100
1100100111000100100110000100100111100111011100001000111010111010000101110111000110010101100000111110011011000111010100010100010011111101110101010010111111100100000110110100110100110110011001110101010001000100111000000010010010011101111011010101010010101010
0001011001000100011000010100110100010111110010101011111111011111011000101010011010001110110000011100110001010011010110010100101101111001001000000100000101001010100100001110011100000001011100001111011001010010100100100110001100001001001000000110110011001100
0000011101000000100100000000111100000001000000011000000001110110000010100011001000000010100000111110001000000001010000010000011101101101100001000010001101100110000100000000111110100010001100101101011011110010100100100010000001010101110010010000000011000000
0001011000100000100000000100110100010100010000001010100001100110000000100000001000000110000000011000000101001001010000100000110101101001101001000010001101100110000100000000101100100110001100001011010001101010101100100000001001011101010010000010000111000000
1001111100100000100000010100101001000110010000000010110010100010000001110001000001010010000101111110001101011001000010010000010001100001011101001000110101100100011110010110111110001110000011011101010001101000101100100000110001001001000110000000001011000000
0000011001111010000100101001010100001101001101001000110110010100001000100000101110010010100010000001000101001101010010000100001100101100100001000001000000010111000100010100110011000001101100100110001001011010100000011001000000111100100010011010000100110000
0000011000000000100100000000000100000110000000011000100100100010000001110001000000000100000000010110001001000001010010010100000101101001100001000000100100100111000100100100110110000111000000000101010001110010100000000000010000001101100010010000000000010000
1010000100001000100000010110001001000110000000110000100110000000000011110001100000000110000000110110101111010001000000010000100001000001010101001000111100010000011000000110010100001010100001000001010001000000100010000000110000001101000100000000001000000000
1000000100011000100100101010001000000001000000111000100110100000001000110000101000000010000010000011000001000000010000000100010000000001100101000011001100010000010000100000000111100011100000100110000000010000100010001001000000011100110110010010001100010000
0000001100111010100100100010000100000001000000111000100110100000001000000000100000000010000010000001000001001001010000000100010000000000100001000011001000010011000000000000100001100001100000100110000000011010100010001001000000011100110110011010001100010000
