1011101000111010001101000011000010111001100110101111000001001000101100101100110100010010000011010001000000001001000001001011010000010010100100110111011010011000110001100000000000110000100011011010000001001000011100010000001010010010011111101010011010000000
1111100000000100101111101011010011010001001110111010000011100000000101011011000101110100011001110010011000100100101000001000110001000101110101111011101010010000010000110001000001110000110010110000100100100100011010010011011110000001010110010001111100101100
1001001100000100000011100111011011010010111101100010000010001100111111111011100010001001100111111111000001101010001000111001011000110101011000001111100100010000011010110001001110011010110110101100001100110011110110010110011100011010101111111001111010100110
0111001110000100011100100011000100110111111001100111101010001000001001111111110011011010000111110111000001001110101101011110011110110101100000001011001100001000111001011001000110111010110010100100000011000110001100010111001011011000110111011100011110101010
1101001110001000101101101010011001110000000110111111001111100000000111011111011100110000001010110011000001001100000010000110110000000101110101110011100111011000110100100000000100100011100010011101000000100000011110010111011010011000010110010110011110101000
0001010111100000101000010111000100110110010010100111000010000010001010101000110001001010001101011101100000110011001011100010011011100011000000001001000110001011011101010011010000011000100100011110110111001010100000110000001010100011110010111110001100011000
1101001110011000101100101011011001110000000010010010000110100100001100011010111100010010001000110010000101001101000011000100110010000101110101101011111010011100010101000001100100111011100011101110000010000000111010011011101010011000010110010111010011111001
1011100101000010000001110010011010010111010101100000101010010100111011110111100111010011110111011111010000011010101110011011001000110001000100111111000110010001011000110011001110001010100100111100101000000010000110001010010100101000111111111000011010110110
0111110101111011000111001011000110011100001101110101100000011100011110101010101100101010111011000001010110011001100000101101100100001000000000110011001000010010011000111001000001111000110100101010111011001100001010011101101100110110101001011011111100100111
1011100111011011000101101011001100111001000101111101111000010000101001110100110110010010100110000011100000001010101100101011101000110000100000110001001000010000010000110101010001100000100010010000100010000110011010011001001000110010011111011110011100100011
0111100010000001101000101001001101110110011000011010010011100010000101011011000000100000001000100010100010000101110001100000010011000111100001101011101110000010010101011011010000110000110000010000010010000100011000110011011001010101110010010100001100101000
0100000101000000000101000000100100000110001000101000101000110010000001111101000110000000110100011011111000100110010100110100000100111111100000010000000111100010000010110000101100010011001100010000001110000110000100000010010010010001101011010001011000100110
0100000111000000000100000000000100010100101000001000101110110110000001110111000110000001110000010111011010000110010100010100001100101101100000010000001110100010000000010000001110110000001100100000001000100110000110010010000110011100101001010001010010101110
0001001001010000111001101011001110110111011110101000111001111110101001011011000110000101100000011010001001000101010100000100011100011111000001000001000010010010000001010010001001010000010100000000001100100100110100110011000010011001011000010001011110100100
1101000100010100111100000010111111110100011010111011111111100000100101111001000100110000000000111010101001000001010100000000100011010101010000001100000110010000110001110000011101000000110010011101010101100000110100000100011011011001001110010001101100100000
0100000101000000100101100101001110001110011000001000100110110010100011110001000110000001110010010111011000001110010000010101011100111110100001110011101110100110000000111001101110110110001000110100101000100110110000110010010101110110111011111001111000101110
0100101111000101100011010010111100010000001100111000111100010101000001110011001100000001110100111110111011011111011100010000000100111111000000001000000111110011001110000110011110000010011100000001001001110010110110100110001111011101001001000101100011111111
1100100101100110100101000100101011000110010100001000111010110011100101100100100110111111110001111101011100000011000100110101000001010001111101010110110100100100000100110001101000100100111011010011110001011100111000000000010100110011011111011001111000000110
1000011101100100111101000000111011001110000110011000111010110111000011100011011110000011110010010101011001001111010100010100011100111100110001100110101111101100100100101000101110100010011100000101011101111010001100000010010110111100011010010000110111000100
0110011101111111110111000100110010001111010100000000101000100101101110100110101110010111100000010101110111001111100100010100111000111000101001100110010001010110111110000000101010101100011011001111011001001010010100001110101110111100011101000011110011000011
1100110101100110000101000000111011001111110100011000111010100011100111100101000110111111110000111101011100000010010100010100100001010001110100010110110101100100000000000000111100100110011011010001110000001100111100000000010100110000001111010000111011000110
0100111101011100110101101000111110000100001100001000111010110111000000000011001110000001110010010010011111001111010100100100011100111100100001100010011011100110000100101001101111100110011101100001001000110010001100001010100100011101111000010101110111001111
1100110101111110100101000100111011001101010100001000101010101111100110100110001110111111110000111101011100001010010100010100110001111000110101010110110001100100100010000000101110100110011011010011110001001010111100001110110110111100001101000011110011000111
1000111100100100100101000000111011001111100100001000101010100111100111100111000110111111110000111101011100000010010100010101110101111000110101010110111001100100100110000100101110100110011011000001010000001100111100000110110100111100111111110000110011000111
1000111100100000100101000000111011000111100100011000001010110111100011000111000110111111110000110100111101000110010100010101110101011101110101010100111101100100000100000100111110100010011011000001010001001100101100000010110100110101011111110000110011000110
0100111110010101110110000100111100101100010100001000101000100111000100100111001110010011000010011001111110001111010100000100011100111000101001000110010001100110100110000000101011100100011011100101011101010010111100001110100110011100110000000111110011001011
0100001100000000100101000000000111000011001100011100101110110010000101010111000110010111110000111110011111000101010100010100110101111101110001010010110111100100000000010000101110110011001011010101000000000100110100010010110110011100011001010001011010101110
1001100110100000101000001001001000110010101010011011100011101010011111111001110100011100001010010110000101100000010001000011011010100111100101111011011100001000110001010010000110111010100011011100100100101111011000110101011001111111010110111100001100100000
0010110101110010111101001010111110011010100010111000000000111111101010000100101110000101110001010000010000000010111100100101011101111010100001100110001011001010100100100000001011100000001100101111111000001010001100001000001110110011110010110010110101000100
0100111111000100100111000000110100000100011100001000101110011111000101010011001110010100110000000110011101000111010100010100011100101101100000110010001111100110000100110100111100100100011100100001001000110110011100000110010110011101011011000101110011101110
0100011101000000110111000000110110000110000100001000111100110111110000100111001010000011110000000110011001000011010111010110010101111001100001000010100101100111000111100000101100100111011100100101011001010010100100000110000010011100001010010001110011010110
0000011001100100011010010100110100110100110010001001111101011111011000100010011010001110010000011100110011010111010110010100000111111001001000000100000101101010100100001100011110000111011100101111011001011011100100100110001000001101001000000111110111001000
1100101111000100100110000000000111100111011100001000101010111010000011010111000110010001100000011010001011000111010100010100010011001101100101010010111111100100000000110000100110110110011001010101000000000110111100000010010010011101010011010101010010101010
0100100111000100100110000000100101100110011100001001101000111010000101010011000111000000100000010110001011000111010100010100110111001101100001110010101111100110000000010100100100110100011001010001011001110110111000000110010010011101011011010101010010101010
0100111110000000111000000000111110100110101010001101101011111011010001010111010001000000100000000010101110000100010111001010011111111111000101100100111101101111100001110110111010000101011101010101010000010100101100000110110011001101011000110000000011111000
0001011001000100011000010100110100010111110011100001101101001111011100101010011010001110010000011000110001010011010110011101101101111001001000000100000101001010100100001100011110000101011100001111011001000010100100100110001100001001000000100110100011000000
0000011000000000100100000100111100010000010001001010100101100111000010100000001000000010000000011000001001000001010000100100011101111011101001000010001101100110000100000000101110100010001110001011011001111010101100100000001001010101010010000010000011000000
1001101100000000100000010100101001000110010000000010100011100011000001110001000001010010000101111110001100010001001010010000000001110011011101001000110101100100011110010110111110001110000011111001010001100110101100100000110001001011100110000000001010000000
0000011001111010000100101001010100001101011101001000110110010100001000100000101110010010101010001001100110001101010010000100001100101100101000000001000000010111000100010100110011000001101100100110001001011010100000011001000000111100100000001010000100110000
0000011100000000100100000000000100000110000000001000100100100010000001110001000000000000000000010110001000000001010010010100001101101001100001000000000100100111000100100100110110000111000000100101010001110010100000000000010000001101000010010000000000010000
0010011000000000100000010100000100000100010000000000100110000010000000000001001000000100000000001010101011010001010010010000000101101001001001000000000100100111001100000110110100000110000000000101010001010000100000000000100000001101000000000010000100010000
1010000100001000100000010110001001000100000000110000100110000000000011110001100000000010000000110110101011010001001000010000100001000001010100001000111100010000011000000110010110001010100001100101010001000000100010000000110000000101000100000000001000000001
0000001100111010100100100010000100000101000000111000000110100000001000000000100000000110000010000001000001000001010000000100011000000000100001000011001000010111000000100100110001100001100000100110000000011010100010001001000000011100110110011010001100010000
