1011101000011010001101000011000010110001100010101111001001001000101100101110110100010010000011010011000100001001000101001011010010010010100100111111011010011000110001100000000000110000110011011010000001001000011100010001001011010000011110101010001010000000
1001001100000100000011100111000011010010111101100010000010001000111111111011100010001001100111111111000001101010001000110001001000110101011000001111100100010000011000110011001110011010100110101100001100110011110110110110011100011010000111111001111010100110
0101100100011101100000111011001110110001001000100010011001100000101101111011100001000111010110101011110111001100001001100000110110010111000001001101000010010011001011010011000101011110110010010000100000000100000010110001101111010110011000001001101000110001
1011101101000010000011110010111010010111110101100010011010110110101001110111110111010011110111010111010000011010101110111011001000110101000100111111011100001001111000110011001110001110100101010000101100100010000100001010010100101000111111111000011110110110
1111100101001010000001110010011010010111010101100000101010010100111011110111100111010011110111010111010000011010101110011000001000110001000100111011100110010001011000110011001110001010100100111100101000000010000110001010010110101000111111011000011010110110
0101000101111011000101001011000110011100001101110101100000011100111010101110101110101010101011010001010110001011100000001110100100001000100000110011001000010010010100010001000001111000110100101010101011001100001010011101101100110110101001011010011100100111
1011000111011011000101101011011000110001001101111011011000000000101101011111110110111010100111000011000000101010101100101110101000010100100000011011001000011000011000110101010001101000100010011000100110010010010010011001001010110000010111011100011000100011
1101110100000001100000101001000011111100101000011011010001100010000101001101010000101010000000100010001000000001010001101000110011000110110101101011111000100100000111110111110001110100000011010000010111010100110000110001010001010111010011011001000100100001
1111100010000001100000101001001011110010101000011010010001100010000101011001000000100001001000100010001000100001010001111000110010000111010101101011111000001000010101010111010001110000100011010000010011000100010000110101010001010111010011011100001100101000
0100001111000000100100000010000100010000001000101000101100110110000011010011000110000001110010000111011000000110010100000100000100101101100001010000000110100010001000010000001110110010001100100100001000100100000100010010000100010100111001010101010010100010
0101001101010100111001110010001110110110011110101000111111111110001001111011000010000001100000011010101011001100010100000100001100011101000001000000000010010010000001010010001001010001010100000000001000010100010100111010000010011100011000010001011110101100
0101001100010100011100110010001111110100011110101010111111100010000101111101010100110000000000111010100001000101010100000100100111010101010000000100000010010000100000011001000001000000110010011000000101100000010100000110011010011001001110010001111100100000
0100100101000000100001100001001110000110011100001000000100110010100011010001000110000011110000111110011000001110010000010000011001101111000001010011101110100010000000111011001110110110011100110100101000000110110000110000010100010110111011000001111000101110
1100011001101110100101000100110011001110010100000000111010100011001100100100101110111111110000110101010111001011100100010100100001010000110101110110110001000100110110000000101000101100111011011111110001001000010100001100110100110101001101011011110001000111
1100011101100110111101000000111011001110000110011000111010110111000001100011001110000011110010010101011001001111010100010100011100111100110001100110101111101100100100101000101110100010011100000001011101111010001100000010010110111100111010010001110111000100
0000011101000100111101000000111111010111100110011000111010111111100011100111011110000011110010010111011001001111010100010101011101111101110001100110101111101010100100100000001110100010011100001001111111000010001100000010010110111100111010110000110111000100
0110011001111111110111000100110010001111010100000000101000100101101110100110101110010111100000010101110110001111100100010100111000111000101001100110010001010110111110000000101000101100011011001111011001001010010100001110101110111100010101000011110011000111
0110011011111111110111000100111100000100010100000000101100000101001110100011001110010011100100001001111111001111100100000100111100111100101000000000000001110110001110000100110011001100011110000111001001001010100110001110100110011100011001000111110111000011
1100110101111110100101000100111011001100010100001000111010100111100110100110001110011111100000111101011100001010010100010100110001111000110101010110110001100100100010000000101110100110011011010011110001001010111100001110110110111100001101000011110011000111
1000111100100100100101000000111011001011100100001000001010100111100111100111000110111111110000111101011100000010010100010101110101111000110101010110111001100100100110000000101110100110011011000001010000001100111100000110110100111100011111110000110011000111
0100111111010101100111000100111100001101010100001000111000100111000100100111001110010011000010011001111110001111010100000100011100111100101001000110010001100110100110000000101011100101011011100101011101010010111100001110100110011100110000000111110011001011
0100000100000000100111000000000111000010001100011100101110110010000101110011000110010111110000111110011111000101010100010100010101011101110001010010110111100100000100010000101100110011011011010101000001000100110100010010110110011101011001010001011010101110
0000011011100000101101000100111100000110110111001101100100110111010010100000011110001110100000010100001000100111110000011110011101101001101000110010001101101110000100101000101010110100001100100111011101111111011100000100000000011111000011100110010011001100
1001100110000000101000001001000000110110011010011011100011100010011111111001110100011100001010010110000101100000010001001011011010100111100101101011011100001000110001110000000110110010100011111100100100100111011000110001011001111111010110111100001100100000
0010110101110010111101000010111110011000100110111000000010111111101010000100111110000110110001010001010000000010111000100101011101101010100001100110001001011010100100100000001011100000001100101111111000001011001000001000001110110011110010110010110101000100
1001000100010110100110101011001011101111101100111010000011100010000101011011100100010000001010000011001101001100010001100100011010100110110101110011011100000100010001110001100111110010110011110100100000000110011000011011010000011100110111011000011100101000
0100100111000100100111000000100100100111011100001000101010111010000101010011000110000101100000010010011111000111010100000100010110011101100101100010101111100110000000010000110110110110011001110101001000110100111000000111010010011101111011010101010000101010
0000011101000000110111000000110100000110010100001100101100110111010000100110001110010011110000000111011001001011010111010111010100011001100001100010001101100111000100100000101110100001011100100101011001010110000100000110000110011100111011010000010011010110
0100011011100100011010010100110100110110110110011001101111011111011000100010011010001110010000011000110011010011010110010100000101111001001000000100000101101010100100001100011110000011011100101111011001011011100100100110001000001001101000000111110111010000
1100100111000100100110001000101111100111011100001000001000111010000101010111000110010001100000011010001111000111010100010100010011011101100101010010111111100100000000110100100110110110011001110001010101000110111000000010010010011101111011010101010010101010
0001011001000100011000010100110100010111110011101001101111011111011100101010011010001110010000001100110011010011010110011101100101111001001000000100000101001010100100001100011110000011011100101111011001010010100100100110001100001101000000100110100111000000
1001101100000000100000010100101001000110010000000010110011100011000001110001000001010000000101111110001101011001000010010000000001110011011101001000110101100100011110010110111110001110000011011001010001100100101100100000110001001011000110000000001010000000
1010011100001001100000001100111001000010010000000000010000100011000001000001000100110100000000100100101101000001100000110000100001010001011101101010111101100100011110000010101100101110001011011101010001100000000100100011110001011101010100000000000011000001
0000011001000000100000000000110100000100001000011000100011110110000010100011001000000010100000011110001000000001010000010000010101001101100001000010100101100110000100100100111110100000001100000001011001100000100100100010000001011101110010010000000011000000
0000011001111010000100101001010100001101011101001000110110010100001000100000101110010010101010000001100100001101010010000100011100101100101001000001000000010111000100010100110011000001101100100110001001011010100000011001000000111100100000001010000100110000
0000011100000000100100000000000100000110000000011000110110100010000001110001000000000100000000010110001000000001010010010100001101101001100001000000000100100111000100100100110110000011000000100101010001110010100000000000010000001101100010010000000000010000
0000011100000000100100010000000100000100000000011000100000000010000011110001001000000100000000001110101000010001010010010100000101101001000001000000000100100111000100100100110110000011000000100101010001110010100000000000000000000101100010010000000000010000
0000111100000000100000010100000100000100010000001000100100000010000010100001001000000100000000001010101011010001010010010100000101001001000001000000000100100111000100100110110110000111000000100101010001110000100000000000000000000101100000000000000100010000
1010000100001000000000010110001001000100000000110000100110000000000001110001100000000110000100110110101111010001001000010000100001000001010100001000111100010000011000000110010100001010100001100101010001000000100010000000110000000001010100000000001000000001
